Grapheme	Zhou	Baxter
^dzʰ	^dzʰ	dz
^pʰ	^pʰ	ph
^t	^t	t
^ʔ	^ʔ	ʔ
^tsʰ	^tsʰ	tsh
^ɖʰ	^ɖʰ	dr
^s	^s	s
^ɣ	^ɣ	h
^ţʰ	^ţʰ	trh
^kʰ	^kʰ	kh
^p	^p	p
^bʰ	^bʰ	b
^k	^k	k
^ţ	^ţ	tr
^tɕ	^tɕ	tsy
^n	^n	n
^j	^j	y
^gʰ	^gʰ	g
^l	^l	l
^nʑ	^nʑ	ny
^	^.	h
^ŋ	^ŋ	ng
^m	^m	m
^dʒʰ	^dʒʰ	dzr
^tʰ	^tʰ	th
^dʰ	^dʰ	d
^x	^x	x
^z	^z	z
^ts	^ts	ts
^ʑ	^ʑ	dzy
^tɕʰ	^tɕʰ	tsyh
^dʐʰ	^dʐʰ	zr
^ʧ	^ʧ	tsr
^ɕ	^ɕ	sy
^ʧʰ	^ʧʰ	tsrh
^ʃ	^ʃ	sr
^ɳ	^ɳ	nr
^dʑʰ	^dʑʰ	zy
^pʰĭ	^pʰ-ĭ	ph-j
^ʔĭ	^ʔ-ĭ	ʔ-j
^ti	^t-i	t-.
^tsʰĭ	^tsʰ-ĭ	tsh-j
^ɖʰĭ	^ɖʰ-ĭ	dr-j
^ţʰĭ	^ţʰ-ĭ	trh-j
^kʰĭ	^kʰ-ĭ	kh-j
^pĭ	^p-ĭ	p-j
^bʰi	^bʰ-i	b-.
^ţĭ	^ţ-ĭ	tr-j
^ɣu	^ɣ-u	h-w
^tɕĭ	^tɕ-ĭ	tsy-.
^kĭ	^k-ĭ	k-j
^bʰĭw	^bʰ-ĭw	b-j
^kw	^k-w	k-w
^jĭ	^j-ĭ	y-.
^gʰĭ	^gʰ-ĭ	g-j
^lu	^l-u	l-w
^ĭ	^.-ĭ	h-j
^mĭw	^m-ĭw	m-j
^nʑĭ	^nʑ-ĭ	ny-.
^dʒʰĭ	^dʒʰ-ĭ	dzr-j
^sĭ	^s-ĭ	s-j
^lĭ	^l-ĭ	l-j
^li	^l-i	l-.
^xĭ	^x-ĭ	x-j
^bʰu	^bʰ-u	b-.
^zĭ	^z-ĭ	z-j
^dʰi	^dʰ-i	d-.
^w	^.-w	h-w
^ʑĭ	^ʑ-ĭ	dzy-.
^tɕʰĭ	^tɕʰ-ĭ	tsyh-.
^bʰĭ	^bʰ-ĭ	b-j
^dʐʰĭ	^dʐʰ-ĭ	zr-.
^tsĭ	^ts-ĭ	ts-j
^lĭu	^l-ĭu	l-w
^ʧĭ	^ʧ-ĭ	tsr-.
^ɕĭ	^ɕ-ĭ	sy-.
^kʰĭw	^kʰ-ĭw	kh-jw
^jĭu	^j-ĭu	y-w
^ŋĭw	^ŋ-ĭw	ng-jw
^si	^s-i	s-.
^ku	^k-u	k-w
^mĭ	^m-ĭ	m-j
^dzʰĭw	^dzʰ-ĭw	dz-jw
^ɣi	^ɣ-i	h-.
^ki	^k-i	k-.
^ţĭw	^ţ-ĭw	tr-jw
^tu	^t-u	t-.
^pʰĭw	^pʰ-ĭw	ph-j
^xĭw	^x-ĭw	x-jw
^ʧʰĭ	^ʧʰ-ĭ	tsrh-j
^dzʰi	^dzʰ-i	dz-.
^jĭw	^j-ĭw	y-.
^xw	^x-w	x-w
^dzʰĭ	^dzʰ-ĭ	dz-j
^pĭw	^p-ĭw	p-j
^tsʰi	^tsʰ-i	tsh-.
^pu	^p-u	p-w
^gʰĭw	^gʰ-ĭw	g-jw
^kĭw	^k-ĭw	k-jw
^ʃĭ	^ʃ-ĭ	sr-j
^ŋĭ	^ŋ-ĭ	ng-j
^tɕʰĭw	^tɕʰ-ĭw	tsyh-w
^kʰu	^kʰ-u	kh-w
^kiw	^k-iw	k-w
^ʑĭw	^ʑ-ĭw	dzy-.
^ŋi	^ŋ-i	ng-.
^ɖʰw	^ɖʰ-w	dr-w
^lw	^l-w	l-w
^ɣw	^ɣ-w	h-w
^ŋu	^ŋ-u	ng-w
^ɳĭ	^ɳ-ĭ	nr-j
^mu	^m-u	m-w
^ʔĭw	^ʔ-ĭw	ʔ-jw
^tsu	^ts-u	ts-w
^sĭw	^s-ĭw	s-jw
^dʑʰĭ	^dʑʰ-ĭ	zy-.
^tsʰu	^tsʰ-u	tsh-w
^tɕĭw	^tɕ-ĭw	tsy-w
^ni	^n-i	n-.
^ʔi	^ʔ-i	ʔ-.
^ĭw	^.-ĭw	h-jw
^pi	^p-i	p-.
^tʰi	^tʰ-i	th-.
^kʰw	^kʰ-w	kh-w
^xu	^x-u	x-w
^gʰw	^gʰ-w	g-jw
^ɣiw	^ɣ-iw	h-w
^lĭw	^l-ĭw	l-jw
^su	^s-u	s-w
^zĭu	^z-ĭu	z-w
^dʰu	^dʰ-u	d-w
^ɕw	^ɕ-w	sy-w
^xiw	^x-iw	x-w
^tsi	^ts-i	tsh-j
^tɕĭu	^tɕ-ĭu	tsy-w
^mĭu	^m-ĭu	m-j
^ŋw	^ŋ-w	ng-w
^ɕĭw	^ɕ-ĭw	sy-w
^kʰi	^kʰ-i	kh-.
^mi	^m-i	m-.
^pĭu	^p-ĭu	p-j
^sw	^s-w	s-w
^dzʰu	^dzʰ-u	dz-w
^dʑʰĭu	^dʑʰ-ĭu	zy-w
^dzʰw	^dzʰ-w	dz-w
^ʔw	^ʔ-w	ʔ-w
^tsĭw	^ts-ĭw	ts-j
^ţw	^ţ-w	tr-w
^zw	^z-w	z-w
^ĭu	^.-ĭu	h-j
^tsĭu	^ts-ĭu	ts-w
^jw	^j-w	y-w
^zĭw	^z-ĭw	z-jw
^tsw	^ts-w	ts-w
^kʰiw	^kʰ-iw	kh-w
^tʰu	^tʰ-u	th-w
^tɕw	^tɕ-w	tsy-w
^xi	^x-i	x-.
æ	æ	ea
u	u	u
ə	ə	i
ĕ	ĕ	i
e	e	e
a	a	a
ɑ	ɑ	a
əu	əu	uw
i	i	ij
ɐ	ɐ	æ
ɒi	ɒi	oj
ɐi	ɐi	ɛj
ɛ	ɛ	e
uə	uə	u
au	au	æw
o	o	o
ai	ai	ea
əi	əi	ɨj
ɛu	ɛu	ew
ei	ei	ej
ɑu	ɑu	aw
ɛi	ɛi	ej
ɔ	ɔ	æw
ɒ	ɒ	o
eu	eu	ew
ɑi	ɑi	aj
ie	ie	e
æi	æi	æj
ĭĕ	ĭĕ	i
ĭɛ	ĭɛ	e
ĭu	ĭu	uw
ĭo	ĭo	o
ĭə	ĭə	?
n	n	n
k	k	k
ŋ	ŋ	ng
t	t	t
m	m	m
p	p	p
æn	æ-n	ea-n
uk	u-k	uw-k
əŋ	ə-ŋ	i-ng
ĕt	ĕ-t	i-t
eŋ	e-ŋ	e-ng
aŋ	a-ŋ	a-ng
ɑm	ɑ-m	a-m
ɐŋ	ɐ-ŋ	æ-ng
uŋ	u-ŋ	uw-ng
ɑn	ɑ-n	a-n
ɐp	ɐ-p	o-p
ət	ə-t	o-t
ɛn	ɛ-n	e-n
uən	uə-n	u-n
ɛk	ɛ-k	e-k
ĕn	ĕ-n	i-n
ĕm	ĕ-m	i-m
ɛŋ	ɛ-ŋ	e-ng
ɐt	ɐ-t	o-t
ɐk	ɐ-k	æ-k
en	e-n	e-n
ɑk	ɑ-k	a-k
ɑŋ	ɑ-ŋ	a-ng
ɐn	ɐ-n	o-n
ək	ə-k	i-k
ɛm	ɛ-m	e-m
ĕp	ĕ-p	i-p
æt	æ-t	ɛ-t
em	e-m	e-m
oŋ	o-ŋ	ow-ng
ɐm	ɐ-m	o-m
ɛt	ɛ-t	e-t
at	a-t	æ-t
ɑt	ɑ-t	a-t
ak	a-k	a-k
uət	uə-t	u-t
ɔk	ɔ-k	æw-k
ɒm	ɒ-m	o-m
æk	æ-k	ɛ-k
ɒp	ɒ-p	o-p
ən	ə-n	o-n
ien	ie-n	e-n
an	a-n	æ-n
ɔŋ	ɔ-ŋ	æw-ng
æŋ	æ-ŋ	ea-ng
ek	e-k	e-k
et	e-t	e-t
ɛp	ɛ-p	e-p
ep	e-p	e-p
ok	o-k	ow-k
am	a-m	æ-m
ĭĕn	ĭĕ-n	i-n
ĭɛn	ĭɛ-n	e-n
ap	a-p	æ-p
ɑp	ɑ-p	a-p
ĭuŋ	ĭu-ŋ	uw-ng
ĭuk	ĭ-u-k	j-uw-k
ĭĕt	ĭ-ĕ-t	.-i-t
ieŋ	i-e-ŋ	.-e-ng
ĭaŋ	ĭ-a-ŋ	j-a-ng
ĭəu	ĭ-əu-.	j-uw-.
ĭɐŋ	ĭ-ɐ-ŋ	j-æ-ng
uɑn	u-ɑ-n	w-a-n
ĭwɐp	ĭw-ɐ-p	j-o-p
wɐi	w-ɐi-.	w-ɛj-.
ĭət	ĭ-ə-t	j-ɨ-t
ĭa	ĭ-a-.	.-æ-.
ĭuən	ĭ-uə-n	j-u-n
ĭwaŋ	ĭw-a-ŋ	j-a-ng
ĭɛk	ĭ-ɛ-k	.-e-k
ĭĕm	ĭ-ĕ-m	.-i-m
ĭəŋ	ĭ-ə-ŋ	.-i-ng
ĭɛŋ	ĭ-ɛ-ŋ	.-e-ng
ĭwɐt	ĭw-ɐ-t	jw-o-t
wi	w-i-.	w-ij-.
uɒi	u-ɒi-.	w-oj-.
ĭe	ĭ-e-.	j-e-.
ĭəi	ĭ-əi-.	j-ɨj-.
ĭuĕn	ĭu-ĕ-n	w-i-n
ĭɐn	ĭ-ɐ-n	j-o-n
ĭək	ĭ-ə-k	.-i-k
ĭwɛŋ	ĭw-ɛ-ŋ	jwi-e-ng
ĭɛm	ĭ-ɛ-m	j-e-m
ĭwɐn	ĭw-ɐ-n	jw-o-n
ĭɛu	ĭ-ɛu-.	j-ew-.
uɑŋ	u-ɑ-ŋ	w-a-ng
ĭĕp	ĭ-ĕ-p	.-i-p
ĭwɛn	ĭw-ɛ-n	jw-e-n
iei	i-ei-.	.-ej-.
iem	i-e-m	.-e-m
ĭwoŋ	ĭw-o-ŋ	j-ow-ng
uoŋ	u-o-ŋ	.-ow-ng
ĭwɐm	ĭw-ɐ-m	j-o-m
ĭɛt	ĭ-ɛ-t	j-e-t
wat	w-a-t	w-æ-t
ĭɛi	ĭ-ɛi-.	ji-ej-.
ĭɐp	ĭ-ɐ-p	j-æ-p
ĭak	ĭ-a-k	j-a-k
ĭuət	ĭ-uə-t	j-u-t
wa	w-a-.	w-æ-.
ĭwəi	ĭw-əi-.	j-ɨj-.
uɑk	u-ɑ-k	w-a-k
wai	w-ai-.	w-ɛ-.
ĭwe	ĭw-e-.	jw-e-.
ieu	i-eu-.	.-ew-.
ĭwɐi	ĭw-ɐi-.	j-oj-.
uɑ	u-ɑ-.	w-a-.
ĭɐm	ĭ-ɐ-m	j-æ-m
uək	u-ə-k	w-i-k
iwei	iw-ei-.	w-ej-.
uɑi	u-ɑi-.	w-aj-.
wæi	w-æi-.	w-æj-.
ji	j-i-.	y-ij-.
iəu	i-əu-.	j-iw-.
iek	i-e-k	.-e-k
ĭwɛk	ĭw-ɛ-k	w-e-k
ĭuĕt	ĭu-ĕ-t	w-i-t
wan	w-a-n	w-æ-n
ĭɐk	ĭ-ɐ-k	j-æ-k
iet	i-e-t	.-e-t
iweŋ	iw-e-ŋ	w-e-ng
uɑt	u-ɑ-t	.-a-t
ĭɛp	ĭ-ɛ-p	.-e-p
ĭwɐk	ĭw-ɐ-k	w-æ-k
iep	i-e-p	j-e-p
ĭən	ĭ-ə-n	j-ɨ-n
ĭwok	ĭw-o-k	.-ow-k
ĭwɐŋ	ĭw-ɐ-ŋ	jw-æ-ng
wɐŋ	w-ɐ-ŋ	w-æ-ng
ĭɐt	ĭ-ɐ-t	j-o-t
uok	u-o-k	.-ow-k
iwet	iw-e-t	w-e-t
ĭwɛt	ĭw-ɛ-t	jw-e-t
wæt	w-æ-t	.-ɛ-t
jĭĕn	j-ĭĕ-n	.-i-n
jĭɛn	j-ĭɛ-n	.-e-n
iwek	iw-e-k	w-e-k
wæk	w-æ-k	w-ea-k
ĭet	ĭ-e-t	.-i-t
ĭwɛi	ĭw-ɛi-.	w-ej-.
ĭwĕn	ĭw-ĕ-n	w-i-n
ĭwi	ĭw-i-.	w-ij-.
wæn	w-æ-n	w-ea-n
ĭwak	ĭw-a-k	j-a-k
iwen	iw-e-n	w-e-n
uəŋ	u-ə-ŋ	w-o-ng
ĭɐi	ĭ-ɐi-.	j-oj-.
wɐk	w-ɐ-k	w-æ-k
jĭuŋ	j-ĭu-ŋ	.-uw-ng
jĭə	j-ĭə-.	?-?-.
jĭo	j-ĭo-.	.-o-.
˩	˩	.
˥˩	˥˩	.
˥	˥	X
˩˥	˩˥	H
^dzʰæn˩	^dzʰ-.-æ-n-˩	?-?-?-n-.
^təŋ˥˩	^t-.-ə-ŋ-˥˩	t-.-o-ng-.
^ʔĭĕt	^ʔ-ĭ-ĕ-t-.	ʔ-j-i-t-.
^tieŋ˥˩	^t-i-e-ŋ-˥˩	t-.-e-ng-.
^tsʰĭĕt	^tsʰ-ĭ-ĕ-t-.	tsh-.-i-t-.
^ɖʰĭaŋ˥	^ɖʰ-ĭ-a-ŋ-˥	dr-j-a-ng-X
^sɑm˥˩	^s-.-ɑ-m-˥˩	s-.-a-m-.
^sɑm˩˥	^s-.-ɑ-m-˩˥	s-.-a-m-H
^ɣa˩˥	^ɣ-.-a-.-˩˥	h-.-æ-.-H
^ɣa˥	^ɣ-.-a-.-˥	h-.-æ-.-X
^ţʰĭəu˥	^ţʰ-ĭ-əu-.-˥	trh-j-uw-.-X
^pʰi˥˩	^pʰ-.-i-.-˥˩	ph-.-ij-.-.
^kʰĭəu˥˩	^kʰ-ĭ-əu-.-˥˩	kh-j-uw-.-.
^pĭɐŋ˥	^p-ĭ-ɐ-ŋ-˥	p-j-æ-ng-X
^bʰieŋ˥	^bʰ-i-e-ŋ-˥	b-.-e-ng-X
^kɑ˩˥	^k-.-ɑ-.-˩˥	k-.-a-.-H
^ţĭuŋ˥˩	^ţ-ĭ-u-ŋ-˥˩	tr-j-uw-ng-.
^ţĭuŋ˩˥	^ţ-ĭ-u-ŋ-˩˥	tr-j-uw-ng-H
^ɣuɑn˩	^ɣ-u-ɑ-n-˩	h-w-a-n-.
^tɕĭu˥	^tɕ-ĭ-u-.-˥	tsy-.-u-.-X
^nɒi˥	^n-.-ɒi-.-˥	n-.-oj-.-X
^kĭəu˥	^k-ĭ-əu-.-˥	k-j-uw-.-X
^tɕĭə˥˩	^tɕ-ĭ-ə-.-˥˩	tsy-.-i-.-.
^ɣu˩	^ɣ-.-u-.-˩	h-.-u-.-.
^bʰĭwɐp	^bʰ-ĭw-ɐ-p-.	b-j-o-p-.
^kwɐi˥˩	^k-w-ɐi-.-˥˩	k-w-ɛj-.-.
^kʰĭət	^kʰ-ĭ-ə-t-.	kh-j-ɨ-t-.
^jĭa˥	^j-ĭ-a-.-˥	y-.-æ-.-X
^kɑn˥˩	^k-.-ɑ-n-˥˩	k-.-a-n-.
^luɑn˩˥	^l-u-ɑ-n-˩˥	l-w-a-n-H
^nʑi˩˥	^nʑ-.-i-.-˩˥	ny-.-ij-.-H
^ĭu˩	^.-ĭ-u-.-˩	h-j-u-.-.
^ĭuən˩	^.-ĭ-uə-n-˩	h-j-u-n-.
^ŋu˥	^ŋ-.-u-.-˥	ng-.-u-.-X
^kəŋ˩˥	^k-.-ə-ŋ-˩˥	h-w-a-n-.
^ʔa˩˥	^ʔ-.-a-.-˩˥	ʔ-.-æ-.-H
^mĭwaŋ˩	^m-ĭw-a-ŋ-˩	m-j-a-ng-.
^kau˥˩	^k-.-au-.-˥˩	k-.-æw-.-.
^ɣɒi˥	^ɣ-.-ɒi-.-˥	h-.-oj-.-X
^jĭɛk	^j-ĭ-ɛ-k-.	y-.-e-k-.
^kĭɐŋ˥˩	^k-ĭ-ɐ-ŋ-˥˩	k-j-æ-ng-.
^nʑĭĕn˩	^nʑ-ĭ-ĕ-n-˩	ny-.-i-n-.
^kĭĕm˥˩	^k-ĭ-ĕ-m-˥˩	k-.-i-m-.
^kɐi˩˥	^k-.-ɐi-.-˩˥	k-.-ɛj-.-H
^nʑĭəŋ˩	^nʑ-ĭ-ə-ŋ-˩	ny-.-i-ng-.
^dʒʰĭə˥	^dʒʰ-ĭ-ə-.-˥	dzr-.-i-.-X
^tʰɑ˥˩	^tʰ-.-ɑ-.-˥˩	th-.-a-.-.
^sĭɛn˥˩	^s-ĭ-ɛ-n-˥˩	s-j-e-n-.
^dʰɒi˩˥	^dʰ-.-ɒi-.-˩˥	d-.-oj-.-H
^lĭɛn˩	^l-ĭ-ɛ-n-˩	l-j-ie-n-.
^lĭɛŋ˩	^l-ĭ-ɛ-ŋ-˩	l-j-ie-ng-.
^lieŋ˩	^l-i-e-ŋ-˩	l-j-e-ng-.
^lĭɛŋ˩˥	^l-ĭ-ɛ-ŋ-˩˥	l-j-ie-ng-H
^lieŋ˩˥	^l-i-e-ŋ-˩˥	l-j-e-ng-H
^jĭə˥	^j-ĭ-ə-.-˥	y-.-i-.-X
^ɖʰĭuŋ˩˥	^ɖʰ-ĭ-u-ŋ-˩˥	dr-j-uw-ng-H
^nʑĭĕm˩	^nʑ-ĭ-ĕ-m-˩	ny-.-i-m-X
^nʑĭĕm˩˥	^nʑ-ĭ-ĕ-m-˩˥	ny-.-i-m-H
^ʔi˥˩	^ʔ-.-i-.-˥˩	ʔ-j-ij-.-.
^bʰĭwɐt	^bʰ-ĭw-ɐ-t-.	b-j-o-t-.
^xĭəu˥˩	^x-ĭ-əu-.-˥˩	x-j-uw-.-.
^pɐk	^p-.-ɐ-k-.	p-.-æ-k-.
^bʰuɑn˥	^bʰ-u-ɑ-n-˥	b-.-a-n-X
^bʰuɑn˩˥	^bʰ-u-ɑ-n-˩˥	b-.-a-n-H
^zĭə˥	^z-ĭ-ə-.-˥	z-.-i-.-X
^dʰien˩	^dʰ-i-e-n-˩	d-.-e-n-X
^dʰien˩˥	^dʰ-i-e-n-˩˥	d-.-e-n-H
^dʰɑn˩	^dʰ-.-ɑ-n-˩	d-.-a-n-.
^dʰɑn˥	^dʰ-.-ɑ-n-˥	d-.-a-n-X
^dʰɑn˩˥	^dʰ-.-ɑ-n-˩˥	d-.-a-n-H
^wi˩˥	^.-w-i-.-˩˥	h-w-ij-.-H
^tsɑ˩˥	^ts-.-ɑ-.-˩˥	ts-.-a-.-H
^ɣɑ˩	^ɣ-.-ɑ-.-˩	h-.-a-.-.
^ɣɑ˥	^ɣ-.-ɑ-.-˥	h-.-a-.-X
^jĭo˩	^j-ĭ-o-.-˩	y-.-o-.-.
^ʑĭa˩	^ʑ-ĭ-a-.-˩	dzy-.-o-.-.
^tsu˩˥	^ts-.-u-.-˩˥	ts-.-u-.-H
^tsɑk	^ts-.-ɑ-k-.	ts-.-a-k-.
^bʰuɒi˩˥	^bʰ-u-ɒi-.-˩˥	b-w-oj-.-H
^kai˥˩	^k-.-ai-.-˥˩	k-.-ɛ-.-.
^lɒi˩	^l-.-ɒi-.-˩	l-.-oj-.-.
^tɕʰĭe˥	^tɕʰ-ĭ-e-.-˥	tsyh-.-e-.-X
^ʔĭəi˥˩	^ʔ-ĭ-əi-.-˥˩	ʔ-j-ɨj-.-.
^ɣəu˩	^ɣ-.-əu-.-˩	h-.-uw-.-.
^bʰĭɛn˩˥	^bʰ-ĭ-ɛ-n-˩˥	b-ji-e-n-H
^bʰĭɛn˩	^bʰ-ĭ-ɛ-n-˩	b-ji-e-n-.
^jĭu˩	^j-ĭ-u-.-˩	y-.-u-.-.
^dʐʰĭə˥	^dʐʰ-ĭ-ə-.-˥	zr-.-i-.-X
^kĭu˥˩	^k-ĭ-u-.-˥˩	k-j-u-.-.
^tsʰɑŋ˥˩	^tsʰ-.-ɑ-ŋ-˥˩	tsh-.-a-ng-.
^ʔĭe˥	^ʔ-ĭ-e-.-˥	ʔ-j-e-.-X
^ʔĭe˩˥	^ʔ-ĭ-e-.-˩˥	ʔ-j-e-.-H
^tsĭa˩˥	^ts-ĭ-a-.-˩˥	ts-j-æ-.-H
^tsĭɛk	^ts-ĭ-ɛ-k-.	ts-j-e-k-.
^lĭuĕn˩	^l-ĭu-ĕ-n-˩	l-w-i-n-.
^ʔĭɐn˥	^ʔ-ĭ-ɐ-n-˥	ʔ-j-o-n-X
^ʧĭək	^ʧ-ĭ-ə-k-.	tsr-.-i-k-.
^bʰɑŋ˩	^bʰ-.-ɑ-ŋ-˩	b-.-a-ng-.
^bʰɑŋ˩˥	^bʰ-.-ɑ-ŋ-˩˥	b-.-a-ng-H
^bʰi˩˥	^bʰ-.-i-.-˩˥	b-j-ij-.-H
^ɕĭaŋ˥˩	^ɕ-ĭ-a-ŋ-˥˩	sy-.-a-ng-.
^ɕĭaŋ˩˥	^ɕ-ĭ-a-ŋ-˩˥	sy-.-a-ng-H
^kʰĭwɛŋ˥˩	^kʰ-ĭw-ɛ-ŋ-˥˩	kh-jw-ie-ng-.
^bʰuk	^bʰ-.-u-k-.	b-.-uw-k-.
^gʰĭɛm˥	^gʰ-ĭ-ɛ-m-˥	g-j-e-m-X
^jĭuĕn˥	^j-ĭu-ĕ-n-˥	y-w-i-n-X
^ŋĭwɐn˩	^ŋ-ĭw-ɐ-n-˩	ng-jw-o-n-.
^tɕʰĭuŋ˥˩	^tɕʰ-ĭ-u-ŋ-˥˩	tsyh-.-uw-ng-.
^ɖʰĭɛu˥	^ɖʰ-ĭ-ɛu-.-˥	dr-j-ew-.-X
^sien˥˩	^s-i-e-n-˥˩	s-.-e-n-.
^sien˩˥	^s-i-e-n-˩˥	s-.-e-n-H
^kuɑŋ˥˩	^k-u-ɑ-ŋ-˥˩	k-w-a-ng-.
^kuɑŋ˩˥	^k-u-ɑ-ŋ-˩˥	k-w-a-ng-H
^mĭɛn˥	^m-ĭ-ɛ-n-˥	m-j-e-n-X
^nʑĭe˩	^nʑ-ĭ-e-.-˩	ny-.-e-.-.
^kĭəŋ˥˩	^k-ĭ-ə-ŋ-˥˩	k-.-i-ng-.
^nʑĭĕp	^nʑ-ĭ-ĕ-p-.	ny-.-i-p-.
^dzʰĭwɛn˩	^dzʰ-ĭw-ɛ-n-˩	dz-jw-e-n-.
^lĭaŋ˥	^l-ĭ-a-ŋ-˥	l-j-a-ng-X
^lĭaŋ˩˥	^l-ĭ-a-ŋ-˩˥	l-j-a-ng-H
^pæt	^p-.-æ-t-.	p-.-ɛ-t-.
^kuŋ˥˩	^k-.-u-ŋ-˥˩	k-.-uw-ng-.
^lĭuk	^l-ĭ-u-k-.	l-j-uw-k-.
^ɣiei˩	^ɣ-i-ei-.-˩	h-.-ej-.-.
^pĭɐŋ˥˩	^p-ĭ-ɐ-ŋ-˥˩	p-j-æ-ng-.
^gʰĭə˩	^gʰ-ĭ-ə-.-˩	g-.-i-.-.
^gʰĭu˩˥	^gʰ-ĭ-u-.-˩˥	g-j-u-.-H
^tien˥	^t-i-e-n-˥	t-.-e-n-X
^kiem˥˩	^k-i-e-m-˥˩	k-.-e-m-.
^kiem˩˥	^k-i-e-m-˩˥	k-.-e-m-H
^ki˩˥	^k-.-i-.-˩˥	k-.-ij-.-H
^ţĭwoŋ˥	^ţ-ĭw-o-ŋ-˥	tr-j-ow-ng-X
^tuoŋ˥˩	^t-u-o-ŋ-˥˩	t-.-ow-ng-.
^pĭəŋ˥˩	^p-ĭ-ə-ŋ-˥˩	p-.-i-ng-.
^tuŋ˥˩	^t-.-u-ŋ-˥˩	t-.-uw-ng-.
^tuŋ˩˥	^t-.-u-ŋ-˩˥	t-.-uw-ng-H
^gʰĭĕm˩	^gʰ-ĭ-ĕ-m-˩	l-.-i-m-.
^lĭĕm˥	^l-ĭ-ĕ-m-˥	l-.-i-m-X
^ki˥	^k-.-i-.-˥	k-.-ij-.-X
^bʰĭwɐm˩	^bʰ-ĭw-ɐ-m-˩	b-j-o-m-.
^pʰĭwɐm˥˩	^pʰ-ĭw-ɐ-m-˥˩	ph-j-o-m-.
^xĭwoŋ˥˩	^x-ĭw-o-ŋ-˥˩	x-j-ow-ng-.
^tɑu˥˩	^t-.-ɑu-.-˥˩	t-.-aw-.-.
^pĭuən˥˩	^p-ĭ-uə-n-˥˩	p-j-u-n-.
^bʰĭuən˩˥	^bʰ-ĭ-uə-n-˩˥	b-j-u-n-H
^ɣieŋ˩	^ɣ-i-e-ŋ-˩	h-.-e-ng-.
^ţĭu˥˩	^ţ-ĭ-u-.-˥˩	tr-j-u-.-.
^lĭɛt	^l-ĭ-ɛ-t-.	l-j-e-t-.
^ʧʰĭo˥˩	^ʧʰ-ĭ-o-.-˥˩	tsrh-j-o-.-.
^bʰĭɛt	^bʰ-ĭ-ɛ-t-.	b-j-e-t-.
^pĭɛt	^p-ĭ-ɛ-t-.	p-j-e-t-.
^li˩˥	^l-.-i-.-˩˥	l-.-ij-.-H
^kwat	^k-w-a-t-.	k-w-æ-t-.
^tɑu˩˥	^t-.-ɑu-.-˩˥	t-.-aw-.-H
^tɕĭɛi˩˥	^tɕ-ĭ-ɛi-.-˩˥	tsy-.-ej-.-H
^kieŋ˥	^k-i-e-ŋ-˥	k-.-e-ng-X
^tsək	^ts-.-ə-k-.	ts-.-o-k-.
^dzʰien˩	^dzʰ-i-e-n-˩	dz-.-e-n-.
^kɑŋ˥˩	^k-.-ɑ-ŋ-˥˩	k-.-a-ng-.
^pʰĭəu˩˥	^pʰ-ĭ-əu-.-˩˥	ph-j-uw-.-H
^pʰĭək	^pʰ-ĭ-ə-k-.	ph-.-i-k-.
^kɑt	^k-.-ɑ-t-.	k-.-a-t-.
^ʧʰĭaŋ˥˩	^ʧʰ-ĭ-a-ŋ-˥˩	tsrh-j-a-ng-.
^ʧʰĭaŋ˩˥	^ʧʰ-ĭ-a-ŋ-˩˥	tsrh-j-a-ng-H
^lĭək	^l-ĭ-ə-k-.	l-.-i-k-.
^ka˥˩	^k-.-a-.-˥˩	k-.-æ-.-.
^dʒʰĭo˩˥	^dʒʰ-ĭ-o-.-˩˥	dzr-j-o-.-H
^kĭɐp	^k-ĭ-ɐ-p-.	k-j-æ-p-.
^jĭwoŋ˥	^j-ĭw-o-ŋ-˥	y-.-ow-ng-X
^lək	^l-.-ə-k-.	l-.-o-k-.
^dʰuŋ˥	^dʰ-.-u-ŋ-˥	d-.-uw-ng-X
^lɑu˩	^l-.-ɑu-.-˩	l-.-aw-.-.
^lɑu˩˥	^l-.-ɑu-.-˩˥	l-.-aw-.-H
^tɕĭak	^tɕ-ĭ-a-k-.	tsy-.-a-k-.
^ʑĭak	^ʑ-ĭ-a-k-.	dzy-.-a-k-.
^mĭuət	^m-ĭ-uə-t-.	m-j-u-t-.
^xwa˩˥	^x-w-a-.-˩˥	x-w-æ-.-H
^pək	^p-.-ə-k-.	p-.-o-k-.
^dzʰĭaŋ˩˥	^dzʰ-ĭ-a-ŋ-˩˥	dz-j-a-ng-H
^pĭwəi˥	^p-ĭw-əi-.-˥	p-j-ɨj-.-X
^pʰĭĕt	^pʰ-ĭ-ĕ-t-.	ph-j-i-t-.
^ʔəu˥˩	^ʔ-.-əu-.-˥˩	ʔ-.-uw-.-.
^tsʰien˥˩	^tsʰ-i-e-n-˥˩	tsh-.-e-n-.
^puɑn˩˥	^p-u-ɑ-n-˩˥	p-.-a-n-H
^ţɔk	^ţ-.-ɔ-k-.	tr-.-æw-k-.
^nɒm˩	^n-.-ɒ-m-˩	n-.-o-m-.
^puɑk	^p-u-ɑ-k-.	p-.-a-k-.
^puk	^p-.-u-k-.	p-.-uw-k-.
^tɕĭɛm˩˥	^tɕ-ĭ-ɛ-m-˩˥	tsy-.-e-m-H
^tɕĭɛm˥˩	^tɕ-ĭ-ɛ-m-˥˩	tsy-.-e-m-.
^kwai˩˥	^k-w-ai-.-˩˥	k-w-ɛ-.-H
^ʔĭĕn˩˥	^ʔ-ĭ-ĕ-n-˩˥	ʔ-j-i-n-H
^ŋĭwe˩	^ŋ-ĭw-e-.-˩	ng-jw-e-.-.
^tsĭək	^ts-ĭ-ə-k-.	ts-.-i-k-.
^gʰĭwɛn˩	^gʰ-ĭw-ɛ-n-˩	g-jw-e-n-.
^gʰĭwɐn˥	^gʰ-ĭw-ɐ-n-˥	g-jw-e-n-X
^kĭwɛn˥	^k-ĭw-ɛ-n-˥	k-jw-e-n-X
^kĭwɛn˩˥	^k-ĭw-ɛ-n-˩˥	k-jw-e-n-H
^kʰĭɐŋ˥˩	^kʰ-ĭ-ɐ-ŋ-˥˩	kh-j-æ-ng-.
^ʔæk	^ʔ-.-æ-k-.	ʔ-.-ɛ-k-.
^ɣəu˥	^ɣ-.-əu-.-˥	h-.-uw-.-X
^ɣəu˩˥	^ɣ-.-əu-.-˩˥	h-.-uw-.-H
^kĭuət	^k-ĭ-uə-t-.	k-j-u-t-.
^kĭwɐt	^k-ĭw-ɐ-t-.	k-jw-o-t-.
^kʰĭo˥	^kʰ-ĭ-o-.-˥	kh-j-o-.-X
^kʰĭo˩˥	^kʰ-ĭ-o-.-˩˥	kh-j-o-.-H
^ĭəu˩˥	^.-ĭ-əu-.-˩˥	h-j-uw-.-H
^gʰĭĕp	^gʰ-ĭ-ĕ-p-.	g-.-i-p-.
^pʰĭwɐn˥˩	^pʰ-ĭw-ɐ-n-˥˩	ph-j-o-n-.
^pĭwɐn˥	^p-ĭw-ɐ-n-˥	p-j-o-n-X
^tsʰĭu˥	^tsʰ-ĭ-u-.-˥	tsh-j-u-.-X
^tsʰəu˥	^tsʰ-.-əu-.-˥	tsh-.-uw-.-X
^kʰəu˥	^kʰ-.-əu-.-˥	kh-.-uw-.-X
^ku˥	^k-.-u-.-˥	k-.-u-.-X
^gʰĭu˩	^gʰ-ĭ-u-.-˩	g-j-u-.-.
^kəu˥˩	^k-.-əu-.-˥˩	k-.-uw-.-.
^kĭu˩˥	^k-ĭ-u-.-˩˥	k-j-u-.-H
^kəu˩˥	^k-.-əu-.-˩˥	k-.-uw-.-H
^kieu˩˥	^k-i-eu-.-˩˥	k-.-ew-.-H
^ɖʰĭɛu˩˥	^ɖʰ-ĭ-ɛu-.-˩˥	dr-j-ew-.-H
^ʑĭɛu˩˥	^ʑ-ĭ-ɛu-.-˩˥	dzy-.-ew-.-H
^kʰɑ˥	^kʰ-.-ɑ-.-˥	kh-.-a-.-X
^jĭə˩	^j-ĭ-ə-.-˩	y-.-i-.-.
^ʃĭə˥	^ʃ-ĭ-ə-.-˥	sr-.-i-.-X
^sĭə˥˩	^s-ĭ-ə-.-˥˩	s-.-i-.-.
^kɑk	^k-.-ɑ-k-.	k-.-a-k-.
^ɣɒp	^ɣ-.-ɒ-p-.	h-.-o-p-.
^kɒp	^k-.-ɒ-p-.	k-.-o-p-.
^kĭĕt	^k-ĭ-ĕ-t-.	k-j-i-t-.
^dʰuŋ˩	^dʰ-.-u-ŋ-˩	d-.-uw-ng-.
^mĭɛŋ˩	^m-ĭ-ɛ-ŋ-˩	m-j-ie-ng-.
^lĭə˩˥	^l-ĭ-ə-.-˩˥	l-.-i-.-H
^tʰu˥	^tʰ-.-u-.-˥	th-.-u-.-X
^tʰu˩˥	^tʰ-.-u-.-˩˥	th-.-u-.-H
^ŋĭĕm˩	^ŋ-ĭ-ĕ-m-˩	ng-.-i-m-.
^ŋĭĕm˩˥	^ŋ-ĭ-ĕ-m-˩˥	ng-.-i-m-H
^bʰĭwɐi˩˥	^bʰ-ĭw-ɐi-.-˩˥	b-j-oj-.-H
^bʰi˥	^bʰ-.-i-.-˥	b-.-ij-.-X
^pĭəu˥	^p-ĭ-əu-.-˥	p-j-uw-.-X
^ɣɒm˩	^ɣ-.-ɒ-m-˩	h-.-o-m-.
^ŋu˩	^ŋ-.-u-.-˩	ng-.-u-.-.
^tɕʰĭwe˥˩	^tɕʰ-ĭw-e-.-˥˩	tsyh-w-e-.-.
^tɕʰĭwe˩˥	^tɕʰ-ĭw-e-.-˩˥	tsyh-w-e-.-H
^ŋa˩	^ŋ-.-a-.-˩	ng-.-æ-.-.
^tɕĭəu˥˩	^tɕ-ĭ-əu-.-˥˩	tsy-.-uw-.-.
^mĭwəi˩˥	^m-ĭw-əi-.-˩˥	m-j-ɨj-.-H
^xɑ˥˩	^x-.-ɑ-.-˥˩	x-.-a-.-.
^xɑ˩˥	^x-.-ɑ-.-˩˥	x-.-a-.-H
^xu˥˩	^x-.-u-.-˥˩	x-.-u-.-.
^mĭɐŋ˩˥	^m-ĭ-ɐ-ŋ-˩˥	m-j-æ-ng-H
^ɣuɑ˩	^ɣ-u-ɑ-.-˩	h-w-a-.-.
^ɣuɑ˩˥	^ɣ-u-ɑ-.-˩˥	h-w-a-.-H
^ɣɐm˩	^ɣ-.-ɐ-m-˩	h-.-ɛ-m-.
^ʔɒi˥˩	^ʔ-.-ɒi-.-˥˩	ʔ-.-oj-.-.
^tsɒi˥˩	^ts-.-ɒi-.-˥˩	ts-.-oj-.-.
^dʰɑŋ˩	^dʰ-.-ɑ-ŋ-˩	d-.-a-ng-.
^mĭuən˩˥	^m-ĭ-uə-n-˩˥	m-j-u-n-H
^ʑĭɛn˥	^ʑ-ĭ-ɛ-n-˥	dzy-.-e-n-X
^xĭə˥	^x-ĭ-ə-.-˥	x-.-i-.-X
^kĭɛu˥˩	^k-ĭ-ɛu-.-˥˩	k-j-ew-.-.
^gʰĭɛu˩	^gʰ-ĭ-ɛu-.-˩	g-j-ew-.-.
^tsĭa˥˩	^ts-ĭ-a-.-˥˩	ts-j-æ-.-.
^ʑĭaŋ˩	^ʑ-ĭ-a-ŋ-˩	dzy-.-a-ng-.
^sieu˩˥	^s-i-eu-.-˩˥	s-.-ew-.-H
^kʰi˩˥	^kʰ-.-i-.-˩˥	kh-.-ij-.-H
^ŋĭɐm˩	^ŋ-ĭ-ɐ-m-˩	ng-j-æ-m-.
^si˩˥	^s-.-i-.-˩˥	s-.-ij-.-H
^ɣuɒi˩	^ɣ-u-ɒi-.-˩	h-w-oj-.-.
^kʰuən˩˥	^kʰ-u-ə-n-˩˥	kh-w-o-n-H
^kuək	^k-u-ə-k-.	k-w-o-k-.
^dʰu˥	^dʰ-.-u-.-˥	d-.-u-.-X
^dzʰɒi˩˥	^dzʰ-.-ɒi-.-˩˥	dz-.-oj-.-H
^dzʰɒi˥	^dzʰ-.-ɒi-.-˥	dz-.-oj-.-X
^kiwei˥˩	^k-iw-ei-.-˥˩	k-w-ej-.-.
^ʑĭwe˩	^ʑ-ĭw-e-.-˩	dzy-w-e-.-.
^tɕĭĕp	^tɕ-ĭ-ĕ-p-.	tsy-.-i-p-.
^kien˥˩	^k-i-e-n-˥˩	k-.-e-n-.
^ŋieu˩	^ŋ-i-eu-.-˩	ng-.-ew-.-.
^pɑu˩˥	^p-.-ɑu-.-˩˥	p-.-aw-.-H
^ɖʰĭaŋ˩	^ɖʰ-ĭ-a-ŋ-˩	dr-j-a-ng-.
^ɖʰwi˩˥	^ɖʰ-w-i-.-˩˥	dr-w-ij-.-H
^kʰĭo˥˩	^kʰ-ĭ-o-.-˥˩	kh-j-o-.-.
^mək	^m-.-ə-k-.	m-.-o-k-.
^lwi˥	^l-w-i-.-˥	l-w-ij-.-X
^kwɐi˩˥	^k-w-ɐi-.-˩˥	k-w-ɛj-.-H
^ɣwɐi˩˥	^ɣ-w-ɐi-.-˩˥	k-w-ɛj-.-H
^zĭɛk	^z-ĭ-ɛ-k-.	z-j-e-k-.
^ŋuɑi˩˥	^ŋ-u-ɑi-.-˩˥	ng-w-aj-.-H
^tɑ˥˩	^t-.-ɑ-.-˥˩	t-.-a-.-.
^jĭa˩˥	^j-ĭ-a-.-˩˥	y-.-æ-.-H
^dʰɑi˩˥	^dʰ-.-ɑi-.-˩˥	d-.-aj-.-H
^dʰɑ˩˥	^dʰ-.-ɑ-.-˩˥	d-.-a-.-H
^tʰien˥˩	^tʰ-.-ie-n-˥˩	th-.-e-n-.
^tʰɑi˩˥	^tʰ-.-ɑi-.-˩˥	th-.-aj-.-H
^bʰĭu˩	^bʰ-ĭ-u-.-˩	b-j-u-.-.
^pĭu˥˩	^p-ĭ-u-.-˥˩	p-j-u-.-.
^kwæi˩˥	^k-w-æi-.-˩˥	k-w-æj-.-H
^ʔĭɛu˥˩	^ʔ-ĭ-ɛu-.-˥˩	ʔ-j-ew-.-.
^ʔĭɛu˥	^ʔ-ĭ-ɛu-.-˥	ʔ-j-ew-.-X
^ʔɑu˥	^ʔ-.-ɑu-.-˥	ʔ-.-æw-.-.
^ʔĭaŋ˥˩	^ʔ-ĭ-a-ŋ-˥˩	ʔ-j-a-ng-.
^ɕĭĕt	^ɕ-ĭ-ĕ-t-.	sy-.-i-t-.
^ji˩	^.-j-i-.-˩	.-y-ij-.-.
^kɐp	^k-.-ɐ-p-.	k-.-ɛ-p-.
^ʔĭɛm˥	^ʔ-ĭ-ɛ-m-˥	ʔ-j-e-m-X
^kĭe˥˩	^k-ĭ-e-.-˥˩	k-j-e-.-.
^bʰĭwoŋ˥	^bʰ-ĭw-o-ŋ-˥	ph-j-ow-ng-X
^tsəu˩˥	^ts-.-əu-.-˩˥	ts-.-uw-.-H
^puən˥˩	^p-u-ə-n-˥˩	p-w-o-n-.
^puən˩˥	^p-u-ə-n-˩˥	p-w-o-n-H
^ɕĭa˥˩	^ɕ-ĭ-a-.-˥˩	sy-.-æ-.-.
^ɳĭo˥	^ɳ-ĭ-o-.-˥	nr-j-o-.-X
^ɳĭo˩˥	^ɳ-ĭ-o-.-˩˥	nr-j-o-.-H
^nu˩	^n-.-u-.-˩	n-.-u-.-.
^nʑĭo˩	^nʑ-ĭ-o-.-˩	ny-.-o-.-.
^nʑĭo˩˥	^nʑ-ĭ-o-.-˩˥	ny-.-o-.-H
^pʰĭwəi˥˩	^pʰ-ĭw-əi-.-˥˩	ph-j-ɨj-.-.
^mĭwaŋ˩˥	^m-ĭw-a-ŋ-˩˥	m-j-a-ng-H
^mĭɛu˩˥	^m-ĭ-ɛu-.-˩˥	m-j-ew-.-H
^muɒi˩˥	^m-u-ɒi-.-˩˥	m-w-oj-.-H
^ɕĭə˥	^ɕ-ĭ-ə-.-˥	sy-.-i-.-X
^ku˥˩	^k-.-u-.-˥˩	k-.-u-.-.
^sĭɛŋ˩˥	^s-ĭ-ɛ-ŋ-˩˥	s-j-e-ng-H
^ʔĭwe˥˩	^ʔ-ĭw-e-.-˥˩	ʔ-jw-e-.-.
^ʔĭwe˥	^ʔ-ĭw-e-.-˥	ʔ-jw-e-.-X
^kan˥˩	^k-.-a-n-˥˩	k-.-æ-n-.
^bʰuɑ˩	^bʰ-u-ɑ-.-˩	b-.-a-.-.
^bʰĭe˥	^bʰ-ĭ-e-.-˥	b-j-ie-.-X
^bʰĭəu˥	^bʰ-ĭ-əu-.-˥	b-j-uw-.-X
^mi˩˥	^m-.-i-.-˩˥	m-.-ij-.-H
^ka˩˥	^k-.-a-.-˩˥	k-.-æ-.-H
^tsĭə˥	^ts-ĭ-ə-.-˥	ts-.-i-.-X
^kʰuŋ˥	^kʰ-.-u-ŋ-˥	kh-.-uw-ng-X
^jĭəŋ˩˥	^j-ĭ-ə-ŋ-˩˥	y-.-i-ng-H
^xau˩˥	^x-.-au-.-˩˥	x-.-æw-.-H
^mɐŋ˩˥	^m-.-ɐ-ŋ-˩˥	m-.-æ-ng-H
^kwi˩˥	^k-w-i-.-˩˥	k-w-ij-.-H
^ɖʰɐk	^ɖʰ-.-ɐ-k-.	dr-.-æ-k-.
^ʔɑn˥˩	^ʔ-.-ɑ-n-˥˩	ʔ-.-a-n-.
^tsuoŋ˥˩	^ts-u-o-ŋ-˥˩	ts-.-ow-ng-.
^kuɑn˥˩	^k-u-ɑ-n-˥˩	k-w-a-n-.
^dʰieŋ˩˥	^dʰ-i-e-ŋ-˩˥	d-.-e-ng-H
^tieŋ˩˥	^t-i-e-ŋ-˩˥	t-.-e-ng-H
^ŋĭe˩	^ŋ-ĭ-e-.-˩	ng-j-e-.-.
^kʰɐk	^kʰ-.-ɐ-k-.	kh-.-æ-k-.
^sĭwɛn˥˩	^s-ĭw-ɛ-n-˥˩	s-jw-e-n-.
^sĭɛu˥˩	^s-ĭ-ɛu-.-˥˩	s-j-ew-.-.
^jĭwoŋ˩	^j-ĭw-o-ŋ-˩	y-.-ow-ng-.
^sĭəu˩˥	^s-ĭ-əu-.-˩˥	s-j-uw-.-H
^sĭuk	^s-ĭ-u-k-.	s-j-uw-k-.
^kĭe˩˥	^k-ĭ-e-.-˩˥	k-j-e-.-H
^mĭĕt	^m-ĭ-ĕ-t-.	m-.-i-t-.
^pĭəu˩˥	^p-ĭ-əu-.-˩˥	p-j-uw-.-H
^ɣɑn˩	^ɣ-.-ɑ-n-˩	h-.-a-n-.
^kwa˥	^k-w-a-.-˥	k-w-æ-.-X
^dʑʰĭĕt	^dʑʰ-ĭ-ĕ-t-.	zy-.-i-t-.
^sĭa˥	^s-ĭ-a-.-˥	s-j-æ-.-X
^tsʰuən˩˥	^tsʰ-u-ə-n-˩˥	tsh-w-o-n-H
^zĭə˩˥	^z-ĭ-ə-.-˩˥	z-.-i-.-H
^pĭwoŋ˥˩	^p-ĭw-o-ŋ-˥˩	p-j-ow-ng-.
^pĭwoŋ˩˥	^p-ĭw-o-ŋ-˩˥	p-j-ow-ng-H
^tsĭaŋ˩˥	^ts-ĭ-a-ŋ-˩˥	ts-j-a-ng-H
^tsĭaŋ˥˩	^ts-ĭ-a-ŋ-˥˩	ts-j-a-ng-.
^tɕĭwɛn˥˩	^tɕ-ĭw-ɛ-n-˥˩	tsy-w-e-n-.
^tsuən˥˩	^ts-u-ə-n-˥˩	ts-w-o-n-.
^zĭĕm˩	^z-ĭ-ĕ-m-˩	z-.-i-m-.
^tuɒi˩˥	^t-u-ɒi-.-˩˥	t-w-oj-.-H
^dʰɑu˩˥	^dʰ-.-ɑu-.-˩˥	d-.-aw-.-H
^sĭɛu˥	^s-ĭ-ɛu-.-˥	s-j-ew-.-X
^ɕĭɛu˥	^ɕ-ĭ-ɛu-.-˥	sy-.-ew-.-X
^ɕĭɛu˩˥	^ɕ-ĭ-ɛu-.-˩˥	sy-.-ew-.-H
^ĭəu˩	^.-ĭ-əu-.-˩	h-j-uw-.-.
^dzʰĭəu˩˥	^dzʰ-ĭ-əu-.-˩˥	dz-j-uw-.-H
^tɕʰĭɛk	^tɕʰ-ĭ-ɛ-k-.	tsyh-.-e-k-.
^ɳi˩	^ɳ-.-i-.-˩	nr-.-ij-.-.
^mĭwəi˥	^m-ĭw-əi-.-˥	m-j-ɨj-.-X
^kĭo˥˩	^k-ĭ-o-.-˥˩	k-j-o-.-.
^ţĭɛn˥	^ţ-ĭ-ɛ-n-˥	tr-j-e-n-X
^li˥	^l-.-i-.-˥	l-.-ij-.-X
^ʃæn˥˩	^ʃ-.-æ-n-˥˩	sr-.-ɛ-n-.
^ŋɔk	^ŋ-.-ɔ-k-.	ng-.-æw-k-.
^dʒʰĭuŋ˩	^dʒʰ-ĭ-u-ŋ-˩	dzr-j-uw-ng-.
^pəŋ˥˩	^p-.-ə-ŋ-˥˩	p-.-o-ng-.
^tɕʰĭwɛn˥˩	^tɕʰ-ĭw-ɛ-n-˥˩	tsyh-w-e-n-.
^kʰau˥	^kʰ-.-au-.-˥	kh-.-æw-.-X
^kʰau˩˥	^kʰ-.-au-.-˩˥	kh-.-æw-.-H
^mĭu˩	^m-ĭ-u-.-˩	m-j-u-.-.
^kĭə˥	^k-ĭ-ə-.-˥	k-.-i-.-X
^pa˥˩	^p-.-a-.-˥˩	p-.-æ-.-.
^ɣɔŋ˩˥	^ɣ-.-ɔ-ŋ-˩˥	h-.-æw-ng-H
^kĭĕn˥˩	^k-ĭ-ĕ-n-˥˩	k-.-i-n-.
^ʑĭə˥	^ʑ-ĭ-ə-.-˥	dzy-.-i-.-X
^pu˩˥	^p-.-u-.-˩˥	p-.-u-.-H
^xĭəi˥˩	^x-ĭ-əi-.-˥˩	x-j-ɨj-.-.
^tɑi˩˥	^t-.-ɑi-.-˩˥	t-.-aj-.-H
^bʰĭɐŋ˩	^bʰ-ĭ-ɐ-ŋ-˩	b-j-æ-ng-.
^nien˩	^n-i-e-n-˩	n-.-e-n-.
^pĭɛŋ˥˩	^p-ĭ-ɛ-ŋ-˥˩	p-j-ie-ng-.
^ɣæŋ˥	^ɣ-.-æ-ŋ-˥	h-.-ɛ-ng-X
^ʔieu˥˩	^ʔ-i-eu-.-˥˩	ʔ-.-ew-.-.
^ʔiəu˩˥	^ʔ-i-əu-.-˩˥	ʔ-j-iw-.-H
^ʔiəu˥˩	^ʔ-i-əu-.-˥˩	ʔ-j-iw-.-.
^kɐŋ˥˩	^k-.-ɐ-ŋ-˥˩	k-.-æ-ng-.
^pĭu˥	^p-ĭ-u-.-˥	p-j-u-.-X
^dʰu˩˥	^dʰ-.-u-.-˩˥	d-.-u-.-H
^dʰɑk	^dʰ-.-ɑ-k-.	d-.-a-k-.
^kʰɑŋ˥˩	^kʰ-.-ɑ-ŋ-˥˩	kh-.-a-ng-.
^lĭɛm˩	^l-ĭ-ɛ-m-˩	l-j-e-m-.
^pĭwɐi˩˥	^p-ĭw-ɐi-.-˩˥	p-j-oj-.-H
^kuɑŋ˥	^k-u-ɑ-ŋ-˥	k-w-a-ng-X
^jĭɛn˩	^j-ĭ-ɛ-n-˩	y-.-e-n-.
^jĭɛn˩˥	^j-ĭ-ɛ-n-˩˥	y-.-e-n-H
^kĭɐn˩˥	^k-ĭ-ɐ-n-˩˥	k-j-o-n-H
^luŋ˩˥	^l-.-u-ŋ-˩˥	l-.-uw-ng-H
^jĭək	^j-ĭ-ə-k-.	y-.-i-k-.
^ɕĭək	^ɕ-ĭ-ə-k-.	sy-.-i-k-.
^kĭuŋ˥˩	^k-ĭ-u-ŋ-˥˩	k-j-uw-ng-.
^tieu˩˥	^t-i-eu-.-˩˥	t-.-ew-.-H
^tiek	^t-i-e-k-.	t-.-e-k-.
^jĭĕn˥	^j-ĭ-ĕ-n-˥	y-.-i-n-X
^jĭĕn˩˥	^j-ĭ-ĕ-n-˩˥	y-.-i-n-H
^pĭuət	^p-ĭ-uə-t-.	p-j-u-t-.
^dʰiei˥	^dʰ-i-ei-.-˥	d-.-ej-.-X
^dʰiei˩˥	^dʰ-i-ei-.-˩˥	d-.-ej-.-H
^ţĭaŋ˥˩	^ţ-ĭ-a-ŋ-˥˩	tr-j-a-ng-.
^ţĭaŋ˩˥	^ţ-ĭ-a-ŋ-˩˥	tr-j-a-ng-H
^gʰĭaŋ˩	^gʰ-ĭ-a-ŋ-˩	g-j-a-ng-.
^mĭe˩	^m-ĭ-e-.-˩	m-j-ie-.-.
^mĭe˥	^m-ĭ-e-.-˥	m-j-e-.-X
^tieu˥˩	^t-i-eu-.-˥˩	t-.-ew-.-.
^ʔĭɐŋ˥	^ʔ-ĭ-ɐ-ŋ-˥	ʔ-j-æ-ng-X
^jĭwɛk	^j-ĭw-ɛ-k-.	y-w-e-k-.
^pĭe˥	^p-ĭ-e-.-˥	p-j-e-.-X
^ĭwaŋ˥	^.-ĭw-a-ŋ-˥	h-jw-a-ng-X
^tɕĭɛŋ˥˩	^tɕ-ĭ-ɛ-ŋ-˥˩	tsy-.-e-ng-.
^dzʰu˩	^dzʰ-.-u-.-˩	dz-.-u-.-.
^lĭuĕt	^l-ĭu-ĕ-t-.	l-w-i-t-.
^zĭo˩	^z-ĭ-o-.-˩	z-j-o-.-.
^kieŋ˩˥	^k-i-e-ŋ-˩˥	k-.-e-ng-H
^dʰu˩	^dʰ-.-u-.-˩	d-.-u-.-.
^tək	^t-.-ə-k-.	t-.-o-k-.
^ŋĭo˩˥	^ŋ-ĭ-o-.-˩˥	ng-j-o-.-H
^pien˩˥	^p-i-e-n-˩˥	p-.-e-n-H
^mĭwəi˩	^m-ĭw-əi-.-˩	m-j-ɨj-.-.
^ţĭəŋ˥˩	^ţ-ĭ-ə-ŋ-˥˩	tr-.-i-ng-.
^sĭĕm˥˩	^s-ĭ-ĕ-m-˥˩	s-.-i-m-.
^pĭĕt	^p-ĭ-ĕ-t-.	p-j-i-t-.
^nʑĭĕn˥	^nʑ-ĭ-ĕ-n-˥	ny-.-i-n-X
^tsʰuən˥	^tsʰ-u-ə-n-˥	tsh-w-o-n-X
^tɕĭə˩˥	^tɕ-ĭ-ə-.-˩˥	tsy-.-i-.-H
^tʰiem˥	^tʰ-i-e-m-˥	th-.-e-m-X
^tʰiem˩˥	^tʰ-i-e-m-˩˥	th-.-e-m-H
^kʰwæi˩˥	^kʰ-w-æi-.-˩˥	kh-w-æj-.-H
^niem˩˥	^n-i-e-m-˩˥	n-.-e-m-H
^xuət	^x-u-ə-t-.	x-w-o-t-.
^sĭə˩˥	^s-ĭ-ə-.-˩˥	s-.-i-.-H
^kĭĕp	^k-ĭ-ĕ-p-.	k-.-i-p-.
^ʔĭwɐn˥˩	^ʔ-ĭw-ɐ-n-˥˩	ʔ-jw-o-n-.
^ʔĭwɐn˩˥	^ʔ-ĭw-ɐ-n-˩˥	ʔ-jw-o-n-H
^ɕĭo˩˥	^ɕ-ĭ-o-.-˩˥	sy-.-o-.-H
^ţʰĭə˥	^ţʰ-ĭ-ə-.-˥	trh-.-i-.-X
^ɣən˩˥	^ɣ-.-ə-n-˩˥	h-.-o-n-H
^ʔən˥˩	^ʔ-.-ə-n-˥˩	ʔ-.-o-n-.
^kĭwoŋ˥˩	^k-ĭw-o-ŋ-˥˩	k-j-ow-ng-.
^sĭək	^s-ĭ-ə-k-.	s-.-i-k-.
^sĭĕt	^s-ĭ-ĕ-t-.	s-.-i-t-.
^ɣwan˩˥	^ɣ-w-a-n-˩˥	h-w-æ-n-H
^pi˥˩	^p-.-i-.-˥˩	p-j-ij-.-.
^gʰwi˩˥	^gʰ-w-i-.-˩˥	g-jw-ij-.-H
^dzʰĭɛŋ˩	^dzʰ-ĭ-ɛ-ŋ-˩	dz-j-e-ng-.
^ɣiwei˩˥	^ɣ-iw-ei-.-˩˥	h-w-ej-.-H
^ʔɒi˩˥	^ʔ-.-ɒi-.-˩˥	ʔ-.-oj-.-H
^kɒm˥	^k-.-ɒ-m-˥	k-.-o-m-X
^kʰɒi˥	^kʰ-.-ɒi-.-˥	kh-.-oj-.-X
^dzʰĭə˩	^dzʰ-ĭ-ə-.-˩	dz-.-i-.-.
^mu˩˥	^m-.-u-.-˩˥	m-.-u-.-H
^kwan˩˥	^k-w-a-n-˩˥	k-w-æ-n-H
^lĭo˩˥	^l-ĭ-o-.-˩˥	l-j-o-.-H
^ʔĭək	^ʔ-ĭ-ə-k-.	ʔ-.-i-k-.
^ɣwɐi˩	^ɣ-w-ɐi-.-˩	h-w-ɛj-.-.
^lĭwɛn˩˥	^l-ĭw-ɛ-n-˩˥	l-jw-e-n-H
^kuɑ˥˩	^k-u-ɑ-.-˥˩	k-w-a-.-.
^ɕĭu˩˥	^ɕ-ĭ-u-.-˩˥	sy-.-u-.-H
^nʑĭuŋ˩	^nʑ-ĭ-u-ŋ-˩	ny-.-uw-ng-.
^ʑĭɛŋ˩	^ʑ-ĭ-ɛ-ŋ-˩	dzy-.-e-ng-.
^ŋɑ˥	^ŋ-.-ɑ-.-˥	ng-.-a-.-X
^ɣuək	^ɣ-u-ə-k-.	h-w-i-k-.
^kĭɐk	^k-ĭ-ɐ-k-.	k-j-æ-k-.
^tɕĭɛn˩˥	^tɕ-ĭ-ɛ-n-˩˥	tsy-.-e-n-H
^liei˩˥	^l-i-ei-.-˩˥	l-.-ej-.-H
^liet	^l-i-e-t-.	l-.-e-t-H
^bʰĭwaŋ˩	^bʰ-ĭw-a-ŋ-˩	b-j-a-ng-.
^ʃĭo˥	^ʃ-ĭ-o-.-˥	sr-j-o-.-X
^kiweŋ˥˩	^k-iw-e-ŋ-˥˩	k-w-e-ng-.
^ɕĭɛn˥˩	^ɕ-ĭ-ɛ-n-˥˩	sy-.-e-n-.
^ɕĭɛn˩˥	^ɕ-ĭ-ɛ-n-˩˥	sy-.-e-n-H
^dzʰɒi˩	^dzʰ-.-ɒi-.-˩	dz-.-oj-.-.
^ʑĭəŋ˩	^ʑ-ĭ-ə-ŋ-˩	dzy-.-i-ng-.
^pʰĭe˥˩	^pʰ-ĭ-e-.-˥˩	ph-j-e-.-.
^pʰĭe˥	^pʰ-ĭ-e-.-˥	ph-j-e-.-X
^bʰɑu˥	^bʰ-.-ɑu-.-˥	b-.-aw-.-X
^ţʰĭəu˥˩	^ţʰ-ĭ-əu-.-˥˩	trh-j-uw-.-.
^pʰĭuət	^pʰ-ĭ-uə-t-.	ph-j-u-t-.
^ɳa˩	^ɳ-.-a-.-˩	nr-.-æ-.-.
^bʰuɑt	^bʰ-u-ɑ-t-.	b-.-a-t-.
^bʰæt	^bʰ-.-æ-t-.	b-.-ɛ-t-.
^pɐi˩˥	^p-.-ɐi-.-˩˥	p-.-ɛj-.-H
^tɕĭəŋ˥	^tɕ-ĭ-ə-ŋ-˥	tsy-.-i-ng-X
^kĭwoŋ˥	^k-ĭw-o-ŋ-˥	k-j-ow-ng-X
^ɖʰĭə˩	^ɖʰ-ĭ-ə-.-˩	dr-.-i-.-.
^ʔɑn˩˥	^ʔ-.-ɑ-n-˩˥	ʔ-.-a-n-H
^tɕĭĕn˥˩	^tɕ-ĭ-ĕ-n-˥˩	tsy-.-i-n-.
^tɕĭĕn˩˥	^tɕ-ĭ-ĕ-n-˩˥	tsy-.-i-n-H
^ʔĭĕp	^ʔ-ĭ-ĕ-p-.	ʔ-j-i-p-.
^tɕĭwe˥	^tɕ-ĭw-e-.-˥	tsy-w-e-.-X
^tɕĭaŋ˥	^tɕ-ĭ-a-ŋ-˥	tsy-.-a-ng-X
^tsĭɛp	^ts-ĭ-ɛ-p-.	ts-j-e-p-.
^suən˥	^s-u-ə-n-˥	s-w-o-n-X
^ţæk	^ţ-.-æ-k-.	tr-.-ɛ-k-.
^tʰiek	^tʰ-i-e-k-.	th-.-e-k-.
^puɑt	^p-u-ɑ-t-.	p-.-a-t-.
^pʰĭu˥	^pʰ-ĭ-u-.-˥	ph-j-u-.-X
^kiek	^k-i-e-k-.	k-.-e-k-.
^kĭo˩˥	^k-ĭ-o-.-˩˥	k-j-o-.-H
^ŋĭə˥	^ŋ-ĭ-ə-.-˥	ng-.-i-.-X
^ɣu˩˥	^ɣ-.-u-.-˩˥	g-.-u-.-H
^ɣuɑk	^ɣ-u-ɑ-k-.	h-w-a-k-.
^ʔĭwɐk	^ʔ-ĭw-ɐ-k-.	ʔ-w-æ-k-.
^ɕĭɛp	^ɕ-ĭ-ɛ-p-.	sy-.-e-p-.
^niep	^n-i-e-p-.	n-j-e-p-.
^tɕĭe˥˩	^tɕ-ĭ-e-.-˥˩	tsy-.-e-.-.
^kɒi˥	^k-.-ɒi-.-˥	k-.-oj-.-X
^pĭwaŋ˥	^p-ĭw-a-ŋ-˥	p-j-a-ng-X
^pĭwaŋ˩˥	^p-ĭw-a-ŋ-˩˥	p-j-a-ng-H
^tɕĭɛŋ˩˥	^tɕ-ĭ-ɛ-ŋ-˩˥	tsy-.-e-ng-H
^ku˩˥	^k-.-u-.-˩˥	k-.-u-.-H
^mĭĕn˥	^m-ĭ-ĕ-n-˥	m-.-i-n-X
^kĭəu˩˥	^k-ĭ-əu-.-˩˥	k-j-uw-.-H
^kɑm˥	^k-.-ɑ-m-˥	k-.-a-m-X
^kĭɐŋ˩˥	^k-ĭ-ɐ-ŋ-˩˥	k-j-æ-ng-H
^tɕĭɛŋ˥	^tɕ-ĭ-ɛ-ŋ-˥	tsy-.-e-ng-X
^pʰĭu˥˩	^pʰ-ĭ-u-.-˥˩	ph-j-u-.-.
^ʃĭu˥	^ʃ-ĭ-u-.-˥	sr-j-u-.-X
^ʃĭu˩˥	^ʃ-ĭ-u-.-˩˥	sr-j-u-.-H
^ʃɔk	^ʃ-.-ɔ-k-.	sr-.-æw-k-.
^lĭɛm˥	^l-ĭ-ɛ-m-˥	l-j-e-m-X
^lĭɛm˩˥	^l-ĭ-ɛ-m-˩˥	l-j-e-m-H
^mĭuən˩	^m-ĭ-uə-n-˩	m-j-u-n-.
^təu˥	^t-.-əu-.-˥	t-.-uw-.-X
^kĭən˥˩	^k-ĭ-ə-n-˥˩	k-j-ɨ-n-.
^kĭən˩˥	^k-ĭ-ə-n-˩˥	k-j-ɨ-n-H
^ʧɐm˥	^ʧ-.-ɐ-m-˥	tsr-.-ɛ-m-X
^sĭe˥˩	^s-ĭ-e-.-˥˩	s-j-e-.-.
^pĭwaŋ˥˩	^p-ĭw-a-ŋ-˥˩	p-j-a-ng-.
^ʔĭo˥˩	^ʔ-ĭ-o-.-˥˩	ʔ-j-o-.-.
^ʔu˥˩	^ʔ-.-u-.-˥˩	ʔ-.-u-.-.
^ɕĭe˥˩	^ɕ-ĭ-e-.-˥˩	sy-.-e-.-.
^ɕĭe˩˥	^ɕ-ĭ-e-.-˩˥	sy-.-e-.-H
^nʑĭĕt	^nʑ-ĭ-ĕ-t-.	ny-.-i-t-.
^tɑn˩˥	^t-.-ɑ-n-˩˥	t-.-a-n-H
^tɕi˥	^tɕ-.-i-.-˥	tsy-.-ij-.-X
^tsɑu˥	^ts-.-ɑu-.-˥	ts-.-aw-.-X
^zĭuĕn˩	^z-ĭu-ĕ-n-˩	z-w-i-n-.
^ɣɑn˥	^ɣ-.-ɑ-n-˥	h-.-a-n-X
^kuən˥˩	^k-u-ə-n-˥˩	k-w-o-n-.
^mĭɐŋ˩	^m-ĭ-ɐ-ŋ-˩	m-j-æ-ng-.
^jĭe˩˥	^j-ĭ-e-.-˩˥	y-.-e-.-H
^sĭɛk	^s-ĭ-ɛ-k-.	s-j-e-k-.
^dzʰɑk	^dzʰ-.-ɑ-k-.	dz-.-a-k-.
^tɕĭɛu˥˩	^tɕ-ĭ-ɛu-.-˥˩	tsy-.-ew-.-.
^ʑĭe˥	^ʑ-ĭ-e-.-˥	dzy-.-e-.-X
^ʑĭə˩	^ʑ-ĭ-ə-.-˩	dzy-.-i-.-.
^tsĭĕn˩˥	^ts-ĭ-ĕ-n-˩˥	ts-.-i-n-H
^ʔan˩˥	^ʔ-.-a-n-˩˥	ʔ-.-æ-n-H
^kĭɐŋ˥	^k-ĭ-ɐ-ŋ-˥	k-j-æ-ng-X
^dzʰɑm˩˥	^dzʰ-.-ɑ-m-˩˥	dz-.-a-m-H
^kʰuɑŋ˩˥	^kʰ-u-ɑ-ŋ-˩˥	kh-w-a-ng-H
^kʰĭwok	^kʰ-ĭw-o-k-.	kh-j-ow-k-.
^kɐŋ˩˥	^k-.-ɐ-ŋ-˩˥	k-.-æ-ng-H
^ɣɑt	^ɣ-.-ɑ-t-.	h-.-a-t-.
^ɕĭo˥˩	^ɕ-ĭ-o-.-˥˩	sy-.-o-.-.
^dzʰɑu˩	^dzʰ-.-ɑu-.-˩	dz-.-aw-.-.
^tsuɑi˩˥	^ts-u-ɑi-.-˩˥	ts-w-aj-.-H
^ɣuɑi˩˥	^ɣ-u-ɑi-.-˩˥	h-w-aj-.-H
^kuɑi˩˥	^k-u-ɑi-.-˩˥	k-w-aj-.-H
^ŋĭwɐt	^ŋ-ĭw-ɐ-t-.	ng-jw-o-t-.
^ĭəu˥	^.-ĭ-əu-.-˥	h-j-uw-.-X
^bʰəŋ˩	^bʰ-.-ə-ŋ-˩	b-.-o-ng-.
^ɖʰĭĕm˥	^ɖʰ-ĭ-ĕ-m-˥	dr-.-i-m-X
^lɑŋ˥	^l-.-ɑ-ŋ-˥	l-.-a-ng-X
^muk	^m-.-u-k-.	m-.-uw-k-.
^muɑt	^m-u-ɑ-t-.	m-.-a-t-.
^puən˥	^p-u-ə-n-˥	p-w-o-n-X
^tɕĭu˥˩	^tɕ-ĭ-u-.-˥˩	tsy-.-u-.-.
^xĭəu˥	^x-ĭ-əu-.-˥	x-j-uw-.-X
^ɣɐŋ˥	^ɣ-.-ɐ-ŋ-˥	h-.-æ-ng-X
^puɒi˥˩	^p-u-ɒi-.-˥˩	p-w-oj-.-.
^pan˥	^p-.-a-n-˥	p-.-æ-n-X
^ɖʰĭĕm˩	^ɖʰ-ĭ-ĕ-m-˩	dzy-.-i-m-.
^tɕĭĕm˥	^tɕ-ĭ-ĕ-m-˥	tsy-.-i-m-X
^tɕĭĕm˩˥	^tɕ-ĭ-ĕ-m-˩˥	tsy-.-i-m-H
^lĭĕm˩	^l-ĭ-ĕ-m-˩	l-.-i-m-.
^kuɑ˥	^k-u-ɑ-.-˥	k-w-a-.-X
^nʑĭɛm˥	^nʑ-ĭ-ɛ-m-˥	ny-.-e-m-X
^nʑĭɛm˩˥	^nʑ-ĭ-ɛ-m-˩˥	ny-.-e-m-H
^ɖʰĭu˥	^ɖʰ-ĭ-u-.-˥	dr-j-u-.-X
^ţĭu˥	^ţ-ĭ-u-.-˥	tr-j-u-.-X
^lĭəu˥	^l-ĭ-əu-.-˥	l-j-uw-.-X
^lĭĕt	^l-ĭ-ĕ-t-.	l-.-i-t-.
^kən˥˩	^k-.-ə-n-˥˩	k-.-o-n-.
^kɐk	^k-.-ɐ-k-.	k-.-æ-k-.
^sɑŋ˥˩	^s-.-ɑ-ŋ-˥˩	s-.-a-ng-.
^kɐŋ˥	^k-.-ɐ-ŋ-˥	k-.-æ-ng-X
^ɖʰĭə˩˥	^ɖʰ-ĭ-ə-.-˩˥	dr-.-i-.-H
^ʑĭək	^ʑ-ĭ-ə-k-.	dzy-.-i-k-.
^ʧʰĭo˥	^ʧʰ-ĭ-o-.-˥	tsrh-j-o-.-X
^ʧʰĭo˩˥	^ʧʰ-ĭ-o-.-˩˥	tsrh-j-o-.-H
^ŋĭɐp	^ŋ-ĭ-ɐ-p-.	ng-j-æ-p-.
^gʰĭək	^gʰ-ĭ-ə-k-.	g-.-i-k-.
^ĭwɐŋ˩	^.-ĭw-ɐ-ŋ-˩	h-jw-æ-ng-.
^mu˩	^m-.-u-.-˩	m-.-u-.-.
^ɣwɐŋ˩	^ɣ-w-ɐ-ŋ-˩	h-w-æ-ng-.
^ɣwɐŋ˩˥	^ɣ-w-ɐ-ŋ-˩˥	h-w-æ-ng-H
^kĭɛm˥	^k-ĭ-ɛ-m-˥	k-j-e-m-X
^ɣam˥	^ɣ-.-a-m-˥	h-.-a-m-X
^kʰĭɐm˩˥	^kʰ-ĭ-ɐ-m-˩˥	kh-j-o-m-H
^xĭən˥˩	^x-ĭ-ə-n-˥˩	x-j-ɨ-n-.
^jĭwok	^j-ĭw-o-k-.	y-.-ow-k-.
^xĭɐt	^x-ĭ-ɐ-t-.	x-j-o-t-.
^kɑ˥˩	^k-.-ɑ-.-˥˩	k-.-a-.-.
^tɕĭə˥	^tɕ-ĭ-ə-.-˥	tsy-.-i-.-X
^tsʰĭe˥	^tsʰ-ĭ-e-.-˥	tsh-j-e-.-X
^bʰu˩˥	^bʰ-.-u-.-˩˥	b-.-u-.-H
^mĭu˥	^m-ĭ-u-.-˥	m-j-u-.-X
^liek	^l-i-e-k-.	l-.-e-k-.
^kĭwəi˥˩	^k-ĭw-əi-.-˥˩	k-jw-ɨj-.-.
^dʰien˥	^dʰ-i-e-n-˥	d-.-e-n-X
^ʑĭu˩	^ʑ-ĭ-u-.-˩	dzy-.-u-.-.
^dʰuɑn˩˥	^dʰ-u-ɑ-n-˩˥	d-w-a-n-H
^məu˥	^m-.-əu-.-˥	m-.-uw-.-X
^dʰuok	^dʰ-u-o-k-.	d-.-ow-k-.
^bʰi˩	^bʰ-.-i-.-˩	b-j-ij-.-.
^pi˥	^p-.-i-.-˥	p-.-ij-.-X
^pi˩˥	^p-.-i-.-˩˥	p-j-ij-.-H
^bʰĭĕt	^bʰ-ĭ-ĕ-t-.	b-j-?-t-.
^mɑu˩	^m-.-ɑu-.-˩	m-.-aw-.-.
^mɑu˩˥	^m-.-ɑu-.-˩˥	m-.-aw-.-H
^tsĭɛŋ˥˩	^ts-ĭ-ɛ-ŋ-˥˩	ts-j-ie-ng-.
^ɕwi˥	^ɕ-w-i-.-˥	sy-w-ij-.-X
^ĭwɐŋ˥	^.-ĭw-ɐ-ŋ-˥	h-jw-æ-ng-X
^gʰĭəu˩	^gʰ-ĭ-əu-.-˩	g-j-uw-.-.
^nʑĭo˥	^nʑ-ĭ-o-.-˥	ny-.-o-.-X
^kɔŋ˥˩	^k-.-ɔ-ŋ-˥˩	k-.-æw-ng-.
^ɖʰĭe˩	^ɖʰ-ĭ-e-.-˩	dr-j-e-.-.
^dʰɑ˩	^dʰ-.-ɑ-.-˩	d-.-a-.-.
^xiwet	^x-iw-e-t-.	x-w-e-t-.
^kiwet	^k-iw-e-t-.	k-w-e-t-.
^dʰɒp	^dʰ-.-ɒ-p-.	d-.-o-p-.
^ʃa˥˩	^ʃ-.-a-.-˥˩	sr-.-æ-.-.
^ʃa˩˥	^ʃ-.-a-.-˩˥	sr-.-æ-.-H
^pĭwəi˩˥	^p-ĭw-əi-.-˩˥	p-j-ɨj-.-H
^ɖʰi˩˥	^ɖʰ-.-i-.-˩˥	dr-.-i-.-.
^tɕĭɛu˥	^tɕ-ĭ-ɛu-.-˥	tsy-.-ew-.-X
^xĭwaŋ˩˥	^x-ĭw-a-ŋ-˩˥	x-jw-a-ng-H
^pĭwɐp	^p-ĭw-ɐ-p-.	p-j-o-p-.
^pʰĭwɐm˩˥	^pʰ-ĭw-ɐ-m-˩˥	ph-j-o-m-H
^tɕĭu˩˥	^tɕ-ĭ-u-.-˩˥	tr-j-u-.-H
^wi˥	^.-w-i-.-˥	h-w-ij-.-X
^ɣɐp	^ɣ-.-ɐ-p-.	h-.-ɛ-p-.
^lĭəu˩	^l-ĭ-əu-.-˩	l-j-uw-.-.
^ɣɑu˥	^ɣ-.-ɑu-.-˥	h-.-aw-.-X
^lɑŋ˩	^l-.-ɑ-ŋ-˩	l-.-a-ng-.
^lɑŋ˩˥	^l-.-ɑ-ŋ-˩˥	l-.-a-ng-H
^bʰĭəu˩	^bʰ-ĭ-əu-.-˩	b-j-uw-.-.
^xɒi˥	^x-.-ɒi-.-˥	x-.-oj-.-X
^jĭĕm˩	^j-ĭ-ĕ-m-˩	y-.-i-m-.
^ɕĭĕm˥˩	^ɕ-ĭ-ĕ-m-˥˩	sy-.-i-m-.
^ɕĭĕm˩˥	^ɕ-ĭ-ĕ-m-˩˥	sy-.-i-m-H
^ʔĭɛm˥˩	^ʔ-ĭ-ɛ-m-˥˩	ʔ-j-e-m-.
^ʔĭɐm˩˥	^ʔ-ĭ-ɐ-m-˩˥	ʔ-j-e-m-H
^tsien˥˩	^ts-i-e-n-˥˩	tsh-j-e-n-H
^tsʰĭɛn˥	^tsʰ-ĭ-ɛ-n-˥	tsh-j-e-n-X
^tɕĭo˥	^tɕ-ĭ-o-.-˥	tsy-.-o-.-X
^gʰĭo˩	^gʰ-ĭ-o-.-˩	g-j-o-.-.
^ʧʰĭək	^ʧʰ-ĭ-ə-k-.	tsrh-.-i-k-.
^ɣuən˩	^ɣ-u-ə-n-˩	h-w-o-n-.
^ɣuən˥	^ɣ-u-ə-n-˥	h-w-o-n-X
^tʰɑŋ˥˩	^tʰ-.-ɑ-ŋ-˥˩	th-.-a-ng-.
^tʰɑŋ˩˥	^tʰ-.-ɑ-ŋ-˩˥	th-.-a-ng-H
^tɕĭuĕn˥	^tɕ-ĭu-ĕ-n-˥	tsy-w-i-n-X
^mĭɛt	^m-ĭ-ɛ-t-.	m-j-ie-t-.
^kuət	^k-u-ə-t-.	k-w-o-t-.
^ɣuət	^ɣ-u-ə-t-.	h-w-ɛ-t-.
^ɣwæt	^ɣ-w-æ-t-.	h-.-ɛ-t-.
^ləu˩˥	^l-.-əu-.-˩˥	l-.-uw-.-H
^jĭɛn˥	^.-j-ĭɛ-n-˥	y-.-e-n-X
^tsĭɛm˥˩	^ts-ĭ-ɛ-m-˥˩	ts-j-e-m-.
^dzʰĭɛm˥	^dzʰ-ĭ-ɛ-m-˥	dz-j-e-m-X
^xuɑ˥	^x-u-ɑ-.-˥	x-w-a-.-X
^tɕĭa˩˥	^tɕ-ĭ-a-.-˩˥	tsy-.-æ-.-H
^tɕĭɛk	^tɕ-ĭ-ɛ-k-.	tsy-.-e-k-.
^ʔĭĕn˥˩	^ʔ-ĭ-ĕ-n-˥˩	ʔ-.-?-n-.
^ʔien˥˩	^ʔ-i-e-n-˥˩	ʔ-.-e-n-.
^ʔĭɐn˥˩	^ʔ-ĭ-ɐ-n-˥˩	ʔ-j-o-n-.
^ʔĭɛn˥˩	^ʔ-ĭ-ɛ-n-˥˩	ʔ-j-e-n-.
^ĭɛn˩	^.-ĭ-ɛ-n-˩	h-j-e-n-.
^nʑĭɛn˩	^nʑ-ĭ-ɛ-n-˩	ny-.-e-n-.
^tɕĭɛu˩˥	^tɕ-ĭ-ɛu-.-˩˥	tsy-.-ew-.-H
^bʰĭwɐn˩	^bʰ-ĭw-ɐ-n-˩	b-j-o-n-.
^nʑĭɛt	^nʑ-ĭ-ɛ-t-.	ny-.-e-t-.
^jĭwɛŋ˩	^j-ĭw-ɛ-ŋ-˩	y-w-e-ng-.
^ʧau˥	^ʧ-.-au-.-˥	tsr-.-æw-.-X
^ʧæŋ˥˩	^ʧ-.-æ-ŋ-˥˩	tsr-.-ɛ-ng-.
^tsĭak	^ts-ĭ-a-k-.	ts-j-a-k-.
^bʰĭu˥	^bʰ-ĭ-u-.-˥	b-j-u-.-X
^nʑĭe˥	^nʑ-ĭ-e-.-˥	ny-.-e-.-X
^dʒʰĭaŋ˩	^dʒʰ-ĭ-a-ŋ-˩	dzr-j-a-ng-.
^ŋĭəu˩	^ŋ-ĭ-əu-.-˩	ng-j-uw-.-.
^dʰək	^dʰ-.-ə-k-.	d-.-o-k-.
^kʰien˥˩	^kʰ-.-ie-n-˥˩	kh-.-e-n-.
^kʰien˩˥	^kʰ-.-ie-n-˩˥	kh-.-e-n-H
^kæi˩˥	^k-.-æi-.-˩˥	k-.-æj-.-H
^gʰĭwaŋ˩	^gʰ-ĭw-a-ŋ-˩	g-jw-a-ng-.
^gʰĭwaŋ˩˥	^gʰ-ĭw-a-ŋ-˩˥	g-jw-a-ng-H
^dʰiek	^dʰ-i-e-k-.	d-.-e-k-.
^kiwek	^k-iw-e-k-.	k-w-e-k-.
^xiwek	^x-iw-e-k-.	x-w-e-k-.
^ɣap	^ɣ-.-a-p-.	h-.-æ-p-.
^ɣwæk	^ɣ-w-æ-k-.	h-w-ea-k-.
^ŋĭwok	^ŋ-ĭw-o-k-.	ng-j-ow-k-.
^ĭwaŋ˩	^.-ĭw-a-ŋ-˩	h-jw-a-ng-.
^ĭwaŋ˩˥	^.-ĭw-a-ŋ-˩˥	h-jw-a-ng-H
^ŋuɑn˩˥	^ŋ-u-ɑ-n-˩˥	ng-w-a-n-H
^ţĭĕn˥˩	^ţ-ĭ-ĕ-n-˥˩	tr-.-i-n-.
^lĭə˥	^l-ĭ-ə-.-˥	l-.-i-.-X
^ʃĭet	^ʃ-ĭ-e-t-.	sr-.-i-t-.
^ŋwa˥	^ŋ-w-a-.-˥	ng-w-æ-.-X
^ŋwa˩˥	^ŋ-w-a-.-˩˥	ng-w-æ-.-H
^tsĭəŋ˩˥	^ts-ĭ-ə-ŋ-˩˥	ts-.-i-ng-H
^kɑm˥˩	^k-.-ɑ-m-˥˩	k-.-a-m-.
^ʑĭĕm˥	^ʑ-ĭ-ĕ-m-˥	dzy-.-i-m-X
^ʑĭĕm˩˥	^ʑ-ĭ-ĕ-m-˩˥	dzy-.-i-m-H
^ʃɐŋ˩˥	^ʃ-.-ɐ-ŋ-˩˥	sr-j-æ-ng-.
^jĭwoŋ˩˥	^j-ĭw-o-ŋ-˩˥	y-.-ow-ng-H
^jĭəu˩	^j-ĭ-əu-.-˩	y-.-uw-.-.
^kap	^k-.-a-p-.	k-.-æ-p-.
^ʔĭwəi˩˥	^ʔ-ĭw-əi-.-˩˥	ʔ-jw-ɨj-.-H
^lĭak	^l-ĭ-a-k-.	l-j-a-k-.
^tɑŋ˥˩	^t-.-ɑ-ŋ-˥˩	t-.-a-ng-.
^tɑŋ˩˥	^t-.-ɑ-ŋ-˩˥	t-.-a-ng-H
^ʃĭo˥˩	^ʃ-ĭ-o-.-˥˩	sr-j-o-.-.
^ŋa˥	^ŋ-.-a-.-˥	ng-.-æ-.-X
^ŋĭə˩	^ŋ-ĭ-ə-.-˩	ng-.-i-.-.
^dzʰĭĕt	^dzʰ-ĭ-ĕ-t-.	dz-.-i-t-.
^bʰĭɐŋ˩˥	^bʰ-ĭ-ɐ-ŋ-˩˥	b-j-æ-ng-H
^kwi˥	^k-w-i-.-˥	k-w-ij-.-X
^pĭwɐt	^p-ĭw-ɐ-t-.	p-j-o-t-.
^bʰɐk	^bʰ-.-ɐ-k-.	b-.-æ-k-.
^kɐi˥˩	^k-.-ɐi-.-˥˩	k-.-ɛj-.-.
^bʰĭe˩	^bʰ-ĭ-e-.-˩	b-j-e-.-.
^ʔĭɛk	^ʔ-ĭ-ɛ-k-.	ʔ-ji-e-k-.
^ɣɑp	^ɣ-.-ɑ-p-.	h-.-a-p-.
^ʑĭɛŋ˩˥	^ʑ-ĭ-ɛ-ŋ-˩˥	dzy-.-e-ng-H
^dzʰĭĕn˥	^dzʰ-ĭ-ĕ-n-˥	dz-.-i-n-X
^tsĭĕn˥	^ts-ĭ-ĕ-n-˥	ts-.-i-n-X
^kam˥˩	^k-.-a-m-˥˩	k-.-æ-m-.
^mĭuk	^m-ĭ-u-k-.	m-j-uw-k-.
^mɐŋ˩	^m-.-ɐ-ŋ-˩	m-.-æ-ng-.
^ɖʰĭək	^ɖʰ-ĭ-ə-k-.	dr-.-i-k-.
^sĭaŋ˥˩	^s-ĭ-a-ŋ-˥˩	s-j-a-ng-.
^sĭaŋ˩˥	^s-ĭ-a-ŋ-˩˥	s-j-a-ng-H
^mi˩	^m-.-i-.-˩	m-.-ij-.-.
^ɕi˥	^ɕ-.-i-.-˥	sy-.-ij-.-X
^ţĭe˥˩	^ţ-ĭ-e-.-˥˩	tr-j-e-.-.
^ʑĭɛk	^ʑ-ĭ-ɛ-k-.	dzy-.-e-k-.
^ŋien˩˥	^ŋ-.-ie-n-˩˥	ng-.-e-n-.
^tsu˥	^ts-.-u-.-˥	ts-.-u-.-X
^dʑʰĭĕn˩	^dʑʰ-ĭ-ĕ-n-˩	zy-.-i-n-.
^zĭaŋ˩	^z-ĭ-a-ŋ-˩	z-j-a-ng-.
^tsĭɛi˩˥	^ts-ĭ-ɛi-.-˩˥	ts-j-ej-.-H
^ʧɐi˩˥	^ʧ-.-ɐi-.-˩˥	tsr-.-eaj-.-H
^kĭĕm˩˥	^k-ĭ-ĕ-m-˩˥	k-.-i-m-H
^pĭuk	^p-ĭ-u-k-.	p-j-uw-k-.
^dʰɒm˥	^dʰ-.-ɒ-m-˥	d-.-o-m-X
^liei˥	^l-i-ei-.-˥	l-.-ej-.-X
^si˥˩	^s-.-i-.-˥˩	s-.-ij-.-.
^tsʰĭəu˥˩	^tsʰ-ĭ-əu-.-˥˩	tsh-j-uw-.-.
^dzʰĭĕn˩	^dzʰ-ĭ-ĕ-n-˩	dz-.-i-n-.
^jĭe˩	^j-ĭ-e-.-˩	y-.-e-.-.
^ɕĭwɛi˩˥	^ɕ-ĭw-ɛi-.-˩˥	sy-w-ej-.-H
^kiei˥˩	^k-i-ei-.-˥˩	k-.-ej-.-.
^kʰiei˥	^kʰ-i-ei-.-˥	kh-.-ej-.-X
^tsĭe˩˥	^ts-ĭ-e-.-˩˥	ts-j-e-.-H
^ʔĭwɐi˩˥	^ʔ-ĭw-ɐi-.-˩˥	ʔ-jw-oj-.-H
^ɣiwet	^ɣ-iw-e-t-.	h-w-e-t-.
^kʰuŋ˥˩	^kʰ-.-u-ŋ-˥˩	kh-.-uw-ng-.
^kʰuŋ˩˥	^kʰ-.-u-ŋ-˩˥	kh-.-uw-ng-X
^kʰĭwe˥˩	^kʰ-ĭw-e-.-˥˩	kh-jw-ie-.-.
^lĭĕp	^l-ĭ-ĕ-p-.	l-.-i-p-.
^tɕĭaŋ˥˩	^tɕ-ĭ-a-ŋ-˥˩	tsy-.-a-ng-.
^gʰĭɐt	^gʰ-ĭ-ɐ-t-.	g-j-o-t-.
^gʰĭɛt	^gʰ-ĭ-ɛ-t-.	g-j-e-t-.
^tuɑn˥˩	^t-u-ɑ-n-˥˩	t-w-a-n-.
^ţĭuk	^ţ-ĭ-u-k-.	tr-j-uw-k-.
^kɑn˥	^k-.-ɑ-n-˥	k-.-a-n-X
^kɑ˥	^k-.-ɑ-.-˥	k-.-a-.-X
^tɒi˥	^t-.-ɒi-.-˥	t-.-oj-.-X
^təŋ˥	^t-.-ə-ŋ-˥	t-.-o-ng-X
^ĭwĕn˩	^.-ĭw-ĕ-n-˩	h-w-i-n-.
^kuɑn˥	^k-u-ɑ-n-˥	k-w-a-n-X
^tsĭɛn˩˥	^ts-ĭ-ɛ-n-˩˥	ts-j-e-n-H
^tuok	^t-u-o-k-.	t-.-ow-k-.
^dʰiem˥	^dʰ-i-e-m-˥	d-.-e-m-X
^ʧĭĕm˥˩	^ʧ-ĭ-ĕ-m-˥˩	tsr-.-i-m-.
^tsɒm˥˩	^ts-.-ɒ-m-˥˩	ts-.-o-m-.
^miei˥	^m-i-ei-.-˥	m-.-ej-.-X
^pĭuən˥	^p-ĭu-ə-n-˥	p-j-u-n-X
^kiəu˥	^k-i-əu-.-˥	k-j-iw-.-X
^ʔĭɛu˩˥	^ʔ-ĭ-ɛu-.-˩˥	ʔ-ji-ew-.-H
^ʔĭak	^ʔ-ĭ-a-k-.	ʔ-j-a-k-.
^ɣuŋ˩	^ɣ-.-u-ŋ-˩	h-.-uw-ng-.
^ʔĭu˥˩	^ʔ-ĭ-u-.-˥˩	ʔ-j-u-.-.
^tɕĭe˥	^tɕ-ĭ-e-.-˥	tsy-.-e-.-X
^su˩˥	^s-.-u-.-˩˥	s-.-u-.-H
^lĭwe˥	^l-ĭw-e-.-˥	l-jw-e-.-X
^lĭwe˩˥	^l-ĭw-e-.-˩˥	l-jw-e-.-H
^tɕĭuŋ˥˩	^tɕ-ĭ-u-ŋ-˥˩	tsy-.-uw-ng-.
^kiet	^k-i-e-t-.	k-.-e-t-.
^dzʰĭwɛt	^dzʰ-ĭw-ɛ-t-.	dz-jw-e-t-.
^kau˥	^k-.-au-.-˥	k-.-æw-.-X
^swi˥˩	^s-w-i-.-˥˩	s-w-ij-.-.
^kieŋ˥˩	^k-i-e-ŋ-˥˩	k-.-e-ng-.
^tsuoŋ˩˥	^ts-u-o-ŋ-˩˥	ts-.-ow-ng-H
^ĭwi˩	^.-ĭw-i-.-˩	y-w-ij-.-.
^kwæn˥˩	^k-w-æ-n-˥˩	k-w-ea-n-.
^kʰĭe˥	^kʰ-ĭ-e-.-˥	kh-j-e-.-X
^ɣuɑn˥	^ɣ-u-ɑ-n-˥	h-w-a-n-X
^lien˩˥	^l-.-ie-n-˩˥	l-.-e-n-H
^bʰuɑ˩˥	^bʰ-u-ɑ-.-˩˥	b-.-a-.-H
^bʰĭwak	^bʰ-ĭw-a-k-.	b-j-a-k-.
^ɣiwen˩	^ɣ-iw-e-n-˩	h-w-e-n-.
^ɣiwen˩˥	^ɣ-iw-e-n-˩˥	h-w-e-n-H
^lĭu˥	^l-ĭ-u-.-˥	l-j-u-.-X
^tsuɑn˥	^ts-u-ɑ-n-˥	ts-w-a-n-X
^mĭwaŋ˥	^m-ĭw-a-ŋ-˥	m-j-a-ng-X
^dzʰuɒi˥	^dzʰ-u-ɒi-.-˥	dz-w-oj-.-X
^ţĭə˩˥	^ţ-ĭ-ə-.-˩˥	tr-.-i-.-H
^ʑĭo˩˥	^ʑ-ĭ-o-.-˩˥	dzy-.-o-.-H
^ma˥	^m-.-a-.-˥	m-.-æ-.-X
^ma˩˥	^m-.-a-.-˩˥	m-.-æ-.-H
^jĭaŋ˩	^j-ĭ-a-ŋ-˩	y-.-a-ng-.
^kʰĭaŋ˥˩	^kʰ-ĭ-a-ŋ-˥˩	kh-j-a-ng-.
^mi˥	^m-.-i-.-˥	m-.-ij-.-X
^ŋĭe˩˥	^ŋ-ĭ-e-.-˩˥	ng-j-e-.-H
^xĭe˥˩	^x-ĭ-e-.-˥˩	x-j-e-.-.
^ĭu˥	^.-ĭ-u-.-˥	h-j-u-.-X
^ĭu˩˥	^.-ĭ-u-.-˩˥	h-j-u-.-H
^tsĭɛn˥	^ts-ĭ-ɛ-n-˥	ts-j-e-n-X
^lɑu˥	^l-.-ɑu-.-˥	l-.-aw-.-X
^tɕĭa˥	^tɕ-ĭ-a-.-˥	tsy-.-æ-.-X
^nʑĭə˩	^nʑ-ĭ-ə-.-˩	ny-.-i-.-.
^nɒi˩˥	^n-.-ɒi-.-˩˥	n-.-oj-.-H
^kæŋ˥˩	^k-.-æ-ŋ-˥˩	k-.-ea-ng-.
^nʑĭə˥	^nʑ-ĭ-ə-.-˥	ny-.-i-.-X
^kæŋ˥	^k-.-æ-ŋ-˥	k-.-ea-ng-X
^lieu˩	^l-i-eu-.-˩	l-.-ew-.-.
^tɕĭək	^tɕ-ĭ-ə-k-.	tsy-.-i-k-.
^jĭuĕt	^j-ĭu-ĕ-t-.	y-w-i-t-.
^ki˥˩	^k-.-i-.-˥˩	k-.-ij-.-.
^sĭɛu˩˥	^s-ĭ-ɛu-.-˩˥	s-j-ew-.-H
^kuəŋ˥˩	^k-u-ə-ŋ-˥˩	k-w-o-ng-.
^ɣau˩	^ɣ-.-au-.-˩	h-.-æw-.-.
^pʰĭwɐi˩˥	^pʰ-ĭw-ɐi-.-˩˥	ph-j-oj-.-H
^ĭwəi˩˥	^.-ĭw-əi-.-˩˥	h-jw-ɨj-.-H
^tɕi˥˩	^tɕ-.-i-.-˥˩	tsy-.-ij-.-.
^dʑʰĭuĕn˩	^dʑʰ-ĭu-ĕ-n-˩	zy-w-i-n-.
^ʑĭĕn˥	^ʑ-ĭ-ĕ-n-˥	dzy-.-i-n-X
^ʔĭəŋ˥˩	^ʔ-ĭ-ə-ŋ-˥˩	ʔ-.-i-ng-.
^lɑp	^l-.-ɑ-p-.	l-.-a-p-.
^ʑĭĕn˩	^ʑ-ĭ-ĕ-n-˩	dzy-.-i-n-.
^ŋuɑ˩˥	^ŋ-u-ɑ-.-˩˥	ng-w-a-.-H
^tsɑŋ˥˩	^ts-.-ɑ-ŋ-˥˩	ts-.-a-ng-.
^dzʰi˩˥	^dzʰ-.-i-.-˩˥	dz-.-ij-.-H
^tɕi˩˥	^tɕ-.-i-.-˩˥	tsy-.-ij-.-H
^gʰĭəu˥	^gʰ-ĭ-əu-.-˥	g-j-uw-.-X
^jĭo˥	^j-ĭ-o-.-˥	y-.-o-.-X
^jĭo˩˥	^j-ĭ-o-.-˩˥	y-.-o-.-H
^xĭəŋ˥˩	^x-ĭ-ə-ŋ-˥˩	x-.-i-ng-.
^xĭəŋ˩˥	^x-ĭ-ə-ŋ-˩˥	x-.-i-ng-H
^kĭo˥	^k-ĭ-o-.-˥	k-j-o-.-X
^lĭaŋ˩	^l-ĭ-a-ŋ-˩	l-j-a-ng-.
^ʃĭək	^ʃ-ĭ-ə-k-.	sr-.-i-k-.
^ŋɑi˩˥	^ŋ-.-ɑi-.-˩˥	ng-.-aj-.-H
^ŋĭɐi˩˥	^ŋ-ĭ-ɐi-.-˩˥	ng-j-oj-.-H
^xwa˥˩	^x-w-a-.-˥˩	x-w-æ-.-.
^pʰĭwaŋ˥˩	^pʰ-ĭw-a-ŋ-˥˩	ph-j-a-ng-.
^ʧʰĭu˥˩	^ʧʰ-ĭ-u-.-˥˩	tsrh-j-u-.-.
^kəu˥	^k-.-əu-.-˥	k-.-uw-.-X
^nʑĭa˩	^nʑ-ĭ-a-.-˩	ny-.-æ-.-.
^nʑĭa˥	^nʑ-ĭ-a-.-˥	ny-.-æ-.-X
^nʑĭak	^nʑ-ĭ-a-k-.	ny-.-a-k-.
^kʰu˥	^kʰ-.-u-.-˥	kh-.-u-.-X
^bʰĭwɐm˥	^bʰ-ĭw-ɐ-m-˥	b-j-o-m-X
^mau˩	^m-.-au-.-˩	m-.-æw-.-.
^tɒp	^t-.-ɒ-p-.	t-.-o-p-.
^nʑĭĕm˥	^nʑ-ĭ-ĕ-m-˥	ny-.-i-m-X
^xuɑŋ˥˩	^x-u-ɑ-ŋ-˥˩	x-w-a-ng-.
^ʧĭaŋ˥˩	^ʧ-ĭ-a-ŋ-˥˩	tsr-j-a-ng-.
^ɣæŋ˩	^ɣ-.-æ-ŋ-˩	h-.-ea-ng-.
^ʔæŋ˥˩	^ʔ-.-æ-ŋ-˥˩	ʔ-.-ea-ng-.
^mɑk	^m-.-ɑ-k-.	m-.-a-k-.
^ɣwa˩	^ɣ-w-a-.-˩	h-w-æ-.-.
^ɣwa˩˥	^ɣ-w-a-.-˩˥	h-w-æ-.-H
^dzʰwi˩˥	^dzʰ-w-i-.-˩˥	dz-w-ij-.-H
^lɑk	^l-.-ɑ-k-.	l-.-a-k-.
^jĭɛp	^j-ĭ-ɛ-p-.	y-.-e-p-.
^bʰu˩	^bʰ-.-u-.-˩	b-.-u-.-.
^tɕĭəŋ˥˩	^tɕ-ĭ-ə-ŋ-˥˩	tsy-.-i-ng-.
^tsʰɑŋ˥	^tsʰ-.-ɑ-ŋ-˥	tsh-.-a-ng-X
^kɑi˩˥	^k-.-ɑi-.-˩˥	k-.-aj-.-H
^kɑp	^k-.-ɑ-p-.	k-.-a-p-.
^miet	^m-i-e-t-.	m-.-e-t-.
^pĭɛi˩˥	^p-ĭ-ɛi-.-˩˥	p-ji-ej-.-H
^sieu˥˩	^s-i-eu-.-˥˩	s-.-ew-.-.
^bʰuɑk	^bʰ-u-ɑ-k-.	b-.-a-k-.
^dzʰɑŋ˩	^dzʰ-.-ɑ-ŋ-˩	dz-.-a-ng-.
^dzʰɑŋ˩˥	^dzʰ-.-ɑ-ŋ-˩˥	dz-.-a-ng-H
^jĭak	^j-ĭ-a-k-.	y-.-a-k-.
^su˥˩	^s-.-u-.-˥˩	s-.-u-.-.
^xu˥	^x-.-u-.-˥	x-.-u-.-X
^ŋĭak	^ŋ-ĭ-a-k-.	ng-j-a-k-.
^tɕʰĭo˥	^tɕʰ-ĭ-o-.-˥	tsyh-.-o-.-X
^tɕʰĭo˩˥	^tɕʰ-ĭ-o-.-˩˥	tsyh-.-o-.-H
^xĭo˥˩	^x-ĭ-o-.-˥˩	x-j-o-.-.
^ŋĭu˩	^ŋ-ĭ-u-.-˩	ng-j-u-.-.
^kwɐk	^k-w-ɐ-k-.	k-w-æ-k-.
^ʔwai˥˩	^ʔ-w-ai-.-˥˩	ʔ-w-ea-.-.
^ʔwa˥˩	^ʔ-w-a-.-˥˩	ʔ-w-ae-.-.
^ʑĭwok	^ʑ-ĭw-o-k-.	dzy-.-ow-k-.
^jĭuŋ˩	^.-j-ĭu-ŋ-˩	y-.-uw-ng-.
^ɣai˥	^ɣ-.-ai-.-˥	h-.-ea-.-X
^ɣɑŋ˩	^ɣ-.-ɑ-ŋ-˩	h-.-a-ng-.
^ɣɐŋ˩	^ɣ-.-ɐ-ŋ-˩	h-.-æ-ng-.
^ɣɑŋ˩˥	^ɣ-.-ɑ-ŋ-˩˥	h-.-a-ng-H
^ɣɐŋ˩˥	^ɣ-.-ɐ-ŋ-˩˥	h-.-æ-ng-H
^ʔĭəi˩˥	^ʔ-ĭ-əi-.-˩˥	ʔ-j-ɨj-.-H
^pĭɛu˥	^p-ĭ-ɛu-.-˥	p-j-ew-.-X
^mĭɛi˩˥	^m-ĭ-ɛi-.-˩˥	m-ji-ej-.-H
^bʰɑu˩	^bʰ-.-ɑu-.-˩	b-.-aw-.-.
^pu˥	^p-.-u-.-˥	p-.-u-.-X
^kien˩˥	^k-i-e-n-˩˥	k-.-e-n-H
^ɣien˩˥	^ɣ-i-e-n-˩˥	h-.-e-n-H
^kĭwe˥˩	^k-ĭw-e-.-˥˩	k-jw-ie-.-.
^ʑi˥	^ʑ-.-i-.-˥	dzy-.-ij-.-X
^ʑi˩˥	^ʑ-.-i-.-˩˥	dzy-.-ij-.-H
^tsʰĭĕn˥˩	^tsʰ-ĭ-ĕ-n-˥˩	tsh-.-i-n-.
^tsʰĭĕn˩˥	^tsʰ-ĭ-ĕ-n-˩˥	tsh-.-i-n-H
^kau˩˥	^k-.-au-.-˩˥	k-.-æw-.-H
^kɔk	^k-.-ɔ-k-.	k-.-æw-k-.
^luk	^l-.-u-k-.	l-.-uw-k-.
^ŋĭɐn˩	^ŋ-ĭ-ɐ-n-˩	ng-j-o-n-.
^kiei˩˥	^k-i-ei-.-˩˥	k-.-ej-.-H
^tʰɑk	^tʰ-.-ɑ-k-.	th-.-a-k-.
^kĭə˩˥	^k-ĭ-ə-.-˩˥	k-.-i-.-H
^pʰĭwaŋ˩˥	^pʰ-ĭw-a-ŋ-˩˥	ph-j-a-ng-H
^xĭo˥	^x-ĭ-o-.-˥	x-j-o-.-X
^ŋiei˩˥	^ŋ-i-ei-.-˩˥	ng-.-ej-.-H
^ɕĭə˩˥	^ɕ-ĭ-ə-.-˩˥	sy-.-i-.-H
^ɕĭə˥˩	^ɕ-ĭ-ə-.-˥˩	sy-.-i-.-.
^kĭwe˥	^k-ĭw-e-.-˥	k-jw-e-.-X
^kʰĭĕt	^kʰ-ĭ-ĕ-t-.	kh-j-i-t-.
^ɣwæi˩˥	^ɣ-w-æi-.-˩˥	h-w-æj-.-H
^ŋĭo˥	^ŋ-ĭ-o-.-˥	ng-j-o-.-X
^ŋu˩˥	^ŋ-.-u-.-˩˥	ng-.-u-.-H
^kan˩˥	^k-.-a-n-˩˥	k-.-æ-n-H
^tɕĭo˥˩	^tɕ-ĭ-o-.-˥˩	tsy-.-o-.-.
^tɕĭa˥˩	^tɕ-ĭ-a-.-˥˩	tsy-.-æ-.-.
^mĭəu˩	^m-ĭ-əu-.-˩	m-j-uw-.-.
^ʔĭɐt	^ʔ-ĭ-ɐ-t-.	ʔ-j-o-t-.
^pɑŋ˩˥	^p-.-ɑ-ŋ-˩˥	p-.-a-ng-H
^kʰiem˥˩	^kʰ-i-e-m-˥˩	kh-.-e-m-.
^kɔŋ˥	^k-.-ɔ-ŋ-˥	k-.-æw-ng-X
^zĭa˩˥	^z-ĭ-a-.-˩˥	z-j-æ-.-H
^miəu˩˥	^m-i-əu-.-˩˥	m-j-iw-.-H
^kĭən˥	^k-ĭ-ə-n-˥	k-j-ɨ-n-X
^tɕĭəŋ˩˥	^tɕ-ĭ-ə-ŋ-˩˥	tsy-.-i-ng-H
^ʧĭĕm˩˥	^ʧ-ĭ-ĕ-m-˩˥	tsr-.-i-m-H
^pʰĭe˩˥	^pʰ-ĭ-e-.-˩˥	ph-ji-e-.-H
^pĭɛn˩˥	^p-ĭ-ɛ-n-˩˥	p-j-e-n-H
^nʑĭaŋ˩˥	^nʑ-ĭ-a-ŋ-˩˥	ny-.-a-ng-H
^kuk	^k-.-u-k-.	k-.-uw-k-.
^dʰəu˩˥	^dʰ-.-əu-.-˩˥	d-.-uw-.-H
^kʰĭəi˥	^kʰ-ĭ-əi-.-˥	kh-j-ɨj-.-X
^ŋĭə˩˥	^ŋ-ĭ-ə-.-˩˥	ng-.-i-.-H
^ŋĭəi˩˥	^ŋ-ĭ-əi-.-˩˥	ng-j-ɨj-.-H
^ţĭo˥˩	^ţ-ĭ-o-.-˥˩	tr-j-o-.-.
^ɖʰĭe˥	^ɖʰ-ĭ-e-.-˥	dr-j-e-.-X
^ɖʰai˥	^ɖʰ-.-ai-.-˥	dr-.-ea-.-X
^ţĭɛŋ˥˩	^ţ-ĭ-ɛ-ŋ-˥˩	tr-j-e-ng-.
^kuŋ˩˥	^k-.-u-ŋ-˩˥	k-.-uw-ng-H
^xuɑ˩˥	^x-u-ɑ-.-˩˥	x-w-a-.-H
^kuɑn˩˥	^k-u-ɑ-n-˩˥	k-w-a-n-H
^ʧæk	^ʧ-.-æ-k-.	tsr-.-ea-k-.
^kĭwəi˩˥	^k-ĭw-əi-.-˩˥	k-jw-ɨj-.-H
^mai˥	^m-.-ai-.-˥	m-.-ea-.-X
^xuɒi˥	^x-u-ɒi-.-˥	x-w-oj-.-X
^tsi˥˩	^ts-.-i-.-˥˩	ts-.-ij-.-.
^ka˥	^k-.-a-.-˥	k-.-æ-.-X
^sĭe˩˥	^s-ĭ-e-.-˩˥	s-j-e-.-H
^ɕĭaŋ˥	^ɕ-ĭ-a-ŋ-˥	sy-.-a-ng-X
^ɣien˩	^ɣ-i-e-n-˩	h-.-e-n-.
^mai˩˥	^m-.-ai-.-˩˥	m-.-ea-.-H
^dzʰĭɛn˩˥	^dzʰ-ĭ-ɛ-n-˩˥	dz-j-e-n-H
^ţi˩˥	^ţ-.-i-.-˩˥	tr-.-ij-.-H
^tɕĭĕt	^tɕ-ĭ-ĕ-t-.	tsy-.-i-t-.
^lɑi˩˥	^l-.-ɑi-.-˩˥	l-.-aj-.-H
^dzʰəŋ˩˥	^dzʰ-.-ə-ŋ-˩˥	dz-.-o-ng-H
^ʑĭɛm˩˥	^ʑ-ĭ-ɛ-m-˩˥	dzy-.-e-m-H
^kʰĭə˥	^kʰ-ĭ-ə-.-˥	kh-.-i-.-X
^ĭwɐt	^.-ĭw-ɐ-t-.	h-jw-o-t-.
^ɣuɑt	^ɣ-u-ɑ-t-.	h-w-a-t-.
^tsĭu˩˥	^ts-ĭ-u-.-˩˥	ts-j-u-.-H
^tsĭwok	^ts-ĭw-o-k-.	ts-j-ow-k-.
^kʰĭwe˥	^kʰ-ĭw-e-.-˥	kh-jw-e-.-X
^gʰĭwe˥	^gʰ-ĭw-e-.-˥	g-jw-e-.-X
^lu˩˥	^l-.-u-.-˩˥	l-.-u-.-H
^tɕʰĭa˥˩	^tɕʰ-ĭ-a-.-˥˩	tsyh-.-æ-.-.
^xĭɐn˥˩	^x-ĭ-ɐ-n-˥˩	x-j-o-n-.
^tɕĭĕn˥	^tɕ-ĭ-ĕ-n-˥	tsy-.-i-n-X
^ţĭɛp	^ţ-ĭ-ɛ-p-.	tr-j-e-p-.
^lĭɛn˥	^l-ĭ-ɛ-n-˥	l-j-e-n-X
^ɕĭu˥˩	^ɕ-ĭ-u-.-˥˩	sy-.-u-.-.
^kʰɑi˩˥	^kʰ-.-ɑi-.-˩˥	k-.-aj-.-H
^ɣat	^ɣ-.-a-t-.	h-.-æ-t-.
^ţĭwɛn˥	^ţ-ĭw-ɛ-n-˥	tr-jw-e-n-X
^ţĭwɛn˩˥	^ţ-ĭw-ɛ-n-˩˥	tr-jw-e-n-H
^sĭĕn˥˩	^s-ĭ-ĕ-n-˥˩	s-.-i-n-.
^bʰĭɛk	^bʰ-ĭ-ɛ-k-.	b-ji-e-k-.
^pĭɛk	^p-ĭ-ɛ-k-.	p-ji-e-k-.
^pʰĭɛk	^pʰ-ĭ-ɛ-k-.	ph-ji-e-k-.
^bʰĭɛn˥	^bʰ-ĭ-ɛ-n-˥	b-j-e-n-X
^bʰæn˩˥	^bʰ-.-æ-n-˩˥	b-.-ea-n-H
^zĭə˩	^z-ĭ-ə-.-˩	z-.-i-.-.
^gʰĭən˥	^gʰ-ĭ-ə-n-˥	g-j-ɨ-n-X
^gʰĭən˩˥	^gʰ-ĭ-ə-n-˩˥	g-j-ɨ-n-H
^miei˩	^m-i-ei-.-˩	m-.-ej-.-.
^ţwi˥˩	^ţ-w-i-.-˥˩	tr-w-ij-.-.
^suŋ˩˥	^s-.-u-ŋ-˩˥	s-.-uw-ng-H
^ŋĭɐk	^ŋ-ĭ-ɐ-k-.	ng-j-æ-k-.
^ɖʰĭuk	^ɖʰ-ĭ-u-k-.	dr-j-uw-k-.
^tʰuŋ˥˩	^tʰ-.-u-ŋ-˥˩	th-.-uw-ng-.
^suk	^s-.-u-k-.	s-.-uw-k-.
^pĭək	^p-ĭ-ə-k-.	p-.-i-k-.
^zwi˩˥	^z-w-i-.-˩˥	z-w-ij-.-H
^ŋĭu˩˥	^ŋ-ĭ-u-.-˩˥	ng-j-u-.-H
^ĭuən˩˥	^.-ĭu-ə-n-˩˥	h-j-u-n-H
^kuɑ˩˥	^k-u-ɑ-.-˩˥	k-w-a-.-H
^dʰɑu˥	^dʰ-.-ɑu-.-˥	d-.-aw-.-X
^tʰɑt	^tʰ-.-ɑ-t-.	th-.-a-t-.
^dʰɑt	^dʰ-.-ɑ-t-.	d-.-a-t-.
^tsɑu˥˩	^ts-.-ɑu-.-˥˩	ts-.-aw-.-.
^tsĭuĕn˥˩	^ts-ĭu-ĕ-n-˥˩	ts-w-i-n-.
^tsʰĭɛn˥˩	^tsʰ-ĭ-ɛ-n-˥˩	tsh-j-e-n-.
^jwi˩	^j-w-i-.-˩	y-w-ij-.-.
^jwi˩˥	^j-w-i-.-˩˥	y-w-ij-.-H
^bʰĭe˩˥	^bʰ-ĭ-e-.-˩˥	b-ji-e-.-H
^ɣwan˩	^ɣ-w-a-n-˩	h-w-æ-n-.
^zĭwɛn˩	^z-ĭw-ɛ-n-˩	z-jw-e-n-.
^pien˥˩	^p-i-e-n-˥˩	p-.-e-n-.
^jĭa˩	^j-ĭ-a-.-˩	y-.-æ-.-.
^zĭa˩	^z-ĭ-a-.-˩	z-j-æ-.-.
^jĭɛŋ˥	^j-ĭ-ɛ-ŋ-˥	y-.-e-ng-X
^kʰĭɐk	^kʰ-ĭ-ɐ-k-.	kh-j-æ-k-.
^bʰu˥	^bʰ-.-u-.-˥	b-.-uw-.-X
^bʰəu˥	^bʰ-.-əu-.-˥	b-.-?-.-X
^kuɑk	^k-u-ɑ-k-.	k-w-a-k-.
^tu˥˩	^t-.-u-.-˥˩	t-.-u-.-.
^lĭĕn˩	^l-ĭ-ĕ-n-˩	l-.-i-n-.
^jĭəu˥	^j-ĭ-əu-.-˥	y-.-uw-.-X
^ɣɑm˩	^ɣ-.-ɑ-m-˩	h-.-a-m-.
^kʰuok	^kʰ-u-o-k-.	kh-.-ow-k-.
^tswi˩˥	^ts-w-i-.-˩˥	ts-w-ij-.-H
^tsʰɒi˥	^tsʰ-.-ɒi-.-˥	tsh-.-oj-.-X
^ɕĭɛk	^ɕ-ĭ-ɛ-k-.	sy-.-e-k-.
^ʑĭo˥	^ʑ-ĭ-o-.-˥	dzy-.-o-.-X
^ŋĭĕn˩	^ŋ-ĭ-ĕ-n-˩	ng-.-i-n-.
^ɣam˩	^ɣ-.-a-m-˩	h-.-æ-m-.
^jĭwɛi˩˥	^j-ĭw-ɛi-.-˩˥	y-w-ej-.-H
^dʰuɑi˩˥	^dʰ-u-ɑi-.-˩˥	d-w-aj-.-H
^dʒʰĭo˩	^dʒʰ-.-ĭo-.-˩	dzr-j-o-.-.
^kĭĕm˥	^k-ĭ-ĕ-m-˥	k-.-i-m-X
^tɕĭwoŋ˥˩	^tɕ-ĭw-o-ŋ-˥˩	tsy-.-ow-ng-.
^kʰɒi˥˩	^kʰ-.-ɒi-.-˥˩	kh-.-oj-.-.
^ɣæn˩	^ɣ-.-æ-n-˩	h-.-ea-n-.
^kʰiwek	^kʰ-iw-e-k-.	kh-w-e-k-.
^kwan˥˩	^k-w-a-n-˥˩	k-w-æ-n-.
^bʰĭwaŋ˩˥	^bʰ-ĭw-a-ŋ-˩˥	b-j-a-ng-H
^ʧĭo˥	^ʧ-ĭ-o-.-˥	tsr-j-o-.-X
^pĭe˥˩	^p-ĭ-e-.-˥˩	p-j-e-.-.
^bʰĭu˩˥	^bʰ-ĭ-u-.-˩˥	b-j-u-.-H
^mɐk	^m-.-ɐ-k-.	m-.-æ-k-.
^ɣɔŋ˩	^ɣ-.-ɔ-ŋ-˩	h-.-æw-ng-.
^kɔŋ˩˥	^k-.-ɔ-ŋ-˩˥	k-.-æw-ng-H
^ɣæn˥	^ɣ-.-æ-n-˥	h-.-ea-n-X
^ţĭək	^ţ-ĭ-ə-k-.	tr-.-i-k-.
^ɖʰĭo˩	^ɖʰ-ĭ-o-.-˩	dr-j-o-.-.
^ɖʰĭo˩˥	^ɖʰ-ĭ-o-.-˩˥	dr-j-o-.-H
^lĭəŋ˩	^l-ĭ-ə-ŋ-˩	l-.-i-ng-.
^ɣɐm˩˥	^ɣ-.-ɐ-m-˩˥	h-.-ea-m-H
^dʰuɒi˩˥	^dʰ-u-ɒi-.-˩˥	d-w-oj-.-H
^zĭwe˩	^z-ĭw-e-.-˩	z-jw-e-.-.
^tʰuɑ˥	^tʰ-u-ɑ-.-˥	th-w-a-.-X
^ʔai˩˥	^ʔ-.-ai-.-˩˥	ʔ-.-ea-.-H
^xĭɛm˥	^x-ĭ-ɛ-m-˥	x-j-æ-m-X
^ʔĭən˥	^ʔ-ĭ-ə-n-˥	ʔ-j-ɨ-n-X
^ʔĭən˩˥	^ʔ-ĭ-ə-n-˩˥	ʔ-j-ɨ-n-H
^lĭwoŋ˥	^l-ĭw-o-ŋ-˥	l-j-ow-ng-X
^tɕwi˥˩	^tɕ-w-i-.-˥˩	tsy-w-ij-.-.
^ʃɔŋ˥˩	^ʃ-.-ɔ-ŋ-˥˩	sr-.-æw-ng-.
^dzʰɒp	^dzʰ-.-ɒ-p-.	dz-.-o-p-.
^lĭe˩	^l-ĭ-e-.-˩	l-j-e-.-.
^lĭe˩˥	^l-ĭ-e-.-˩˥	l-j-e-.-H
^sĭwɛt	^s-ĭw-ɛ-t-.	s-jw-e-t-.
^pa˩˥	^p-.-a-.-˩˥	p-.-æ-.-H
^pĭwəi˥˩	^p-ĭw-əi-.-˥˩	p-j-ɨj-.-.
^mĭɛn˩˥	^m-ĭ-ɛ-n-˩˥	m-ji-e-n-H
^kæk	^k-.-æ-k-.	k-.-ea-k-.
^ĭwəi˩	^.-ĭw-əi-.-˩	h-jw-ɨj-.-.
^kʰĭwɛŋ˥	^kʰ-ĭw-ɛ-ŋ-˥	kh-jwi-e-ng-X
^ɣɔŋ˥	^ɣ-.-ɔ-ŋ-˥	h-.-æw-ng-X
^dʑʰĭuĕn˩˥	^dʑʰ-ĭu-ĕ-n-˩˥	zy-w-i-n-H
^sĭu˥˩	^s-ĭ-u-.-˥˩	s-j-u-.-.
^zĭwoŋ˩˥	^z-ĭw-o-ŋ-˩˥	z-j-ow-ng-H
^bʰĭĕn˩	^bʰ-ĭ-ĕ-n-˩	b-j-i-n-.
^ŋĭwɐn˩˥	^ŋ-ĭw-ɐ-n-˩˥	ng-jw-o-n-H
^lwi˩˥	^l-w-i-.-˩˥	l-w-ij-.-H
^jĭə˩˥	^.-j-ĭə-.-˩˥	?-?-?-.-H
^dʑʰĭək	^dʑʰ-ĭ-ə-k-.	zy-.-i-k-.
^ʔĭĕm˥	^ʔ-ĭ-ĕ-m-˥	ʔ-.-i-m-X
^ʔĭĕm˩˥	^ʔ-ĭ-ĕ-m-˩˥	ʔ-.-i-m-H
^jĭaŋ˥	^j-ĭ-a-ŋ-˥	y-.-a-ng-X
^jĭaŋ˩˥	^j-ĭ-a-ŋ-˩˥	y-.-a-ng-H
^xĭaŋ˥˩	^x-ĭ-a-ŋ-˥˩	x-j-a-ng-.
^xieŋ˥˩	^x-i-e-ŋ-˥˩	x-.-e-ng-.
^bʰĭuŋ˩	^bʰ-ĭ-u-ŋ-˩	b-j-uw-ng-.
^bʰĭəŋ˩	^bʰ-ĭ-ə-ŋ-˩	b-.-i-ng-.
^kʰĭu˥˩	^kʰ-ĭ-u-.-˥˩	kh-j-u-.-.
^kʰĭu˩˥	^kʰ-ĭ-u-.-˩˥	kh-j-u-.-H
^sĭwe˥	^s-ĭw-e-.-˥	s-jw-e-.-X
^kĭwəi˥	^k-ĭw-əi-.-˥	k-jw-ɨj-.-X
^lu˥	^l-.-u-.-˥	l-.-u-.-X
^kwæn˩˥	^k-w-æ-n-˩˥	k-w-ea-n-H
^kĭəu˥˩	^k-ĭ-əu-.-˥˩	k-j-uw-.-.
^ɖʰĭĕm˩˥	^ɖʰ-ĭ-ĕ-m-˩˥	dr-.-i-m-H
^ŋan˩˥	^ŋ-.-a-n-˩˥	ng-.-æ-n-H
^ʔiei˥˩	^ʔ-i-ei-.-˥˩	ʔ-.-.-ej-.
^jĭɛm˩	^j-ĭ-ɛ-m-˩	y-.-e-m-.
^jĭɛm˩˥	^j-ĭ-ɛ-m-˩˥	y-.-e-m-H
^mæk	^m-.-æ-k-.	m-.-ɛ-k-.
^ɣuɑŋ˩	^ɣ-u-ɑ-ŋ-˩	h-w-a-ng-.
^ɣæt	^ɣ-.-æ-t-.	h-.-ɛ-t-.
^tɑŋ˥	^t-.-ɑ-ŋ-˥	t-.-a-ng-X
^tieŋ˥	^t-i-e-ŋ-˥	t-.-e-ng-X
^	NULL	NULL
